bahubali	बाहुबली
liye	लिए
line	लाइन
lag	लग
sakte	सकते
hai	हैं
desh	देश
kyun	क्यों
lage	लगे
agar	अगर
political	पॉलिटिकल
bhi	भी
daayre	दायरे
aa	आ
jati	जाती
patthar	पत्थर
hote	होते
nahi	नहीं
hua	हुआ
lekin	लेकिन
yeh	यह
baat	बात
public	पब्लिक
tak	तक
pahuncha	पहुँचा
sake	सके
level	लेवल
kaam	काम
kabhi	कभी
aap	आप
lokpal	लोकपाल
par	पर
ki	की
kyo	क्यों
aakhir	आखिर
modi	मोदी
ji	जी
kya	क्या
rakha	रखा
media	मीडिया
ko	को
naxali	नक्सली
aatankwad	आतंकवाड
mila	मिला
bas	बस
vishwas	विश्वास
dila	दिला
kewal	केवल
jaisa	जैसा
kar	कर
hain	हैं
jiska	जिसका
zero	ज़ीरो
pehle	पहले
tum	तुम
logon	लोगों
ka	का
mudda	मुद्दा
uthaya	उठाया
janta	जानता
tumhe	तुम्हे
dikha	दिखा
di	दी
bhana	भाना
baad	बाद
khtam	ख्तम
chote	छोटे
phaisale	फैसले
lene	लेने
kuch	कुछ
hoga	होगा
chod	छोड़
naqli	नकली
sakti	सक्ती
vote	वोट
wahi	वही
phir	फिर
baar	बार
karo	करो
modiji	मोदीजी
paththarwazon	पत्थरवाज़ों
kamar	कमर
tod	तोड़
degi	देगी
sari	सारी
khatm	खत्म
chuki	चुकी
jai	जय
hind	हिन्द
aam	आम
laakh	लाख
aaye	आये
akele	अकेले
sabka	सबका
paisa	पैसा
kaise	कैसे
ghot	घोट
atankiyo	अटन्कियो
karni	करनी
kaka	काका
lekar	लेकर
gae	गाए
viagra	विआगरा
aatankvad	आतंकवाद
khatam	खतम
honai	होनाई
wala	वाला
sawal	सवाल
puchna	पूछ्ना
himmat	हिम्मत
sir	सिर
bihar	बिहार
aaj	आज
raat	रात
bje	ब्जे
tejaswi	तेजस्वी
valid	वालिड
rahenge	रहेंगे
hogi	होगी
lakar	लकर
badal	बादल
diya	दिया
aagai	आगाई
dhekhlo	धेखलो
wtsaap	वत्साप
imagine	इमेंजिन
mein	मैं
pata	पता
inhe	इन्हे
ban	बन
hui	हुई
fail	फेल
bhakto	भक्तो
bajao	बजाओ
taali	ताली
kaho	कहो
sanghi	संघी
mera	मेरा
raha	रहा
aache	आचे
din	दिन
gaye	गये
haal	हाल
saal	साल
maar	मार
pehli	पहली
barbad	बर्बाद
kiya	किया
sab	सब
vyaapari	व्यापरी
har	हर
chunav	चुनव
jita	जीता
rahe	रहे
sirji	सिरजी
gumraah	गुमराह
karne	करने
banane	बनाने
lambi	लम्बी
khade	खड़े
itni	इतनी
aasaani	आसानी
taqleefein	तकलीफ़ें
bhool	भूल
bina	बिना
koi	कोई
virodh	विरोध
kiye	किए
mushkilon	मुश्किलों
dhakele	धकेले
ja	जा
jab	जब
aapne	अपने
aapka	आपका
dukh	दुख
sehte	सहते
pura	पूरा
saath	साथ
usi	उसी
tarah	तरह
kide	किड
sanvidhan	संविधान
nikal	निकल
dijiye	दीजिये
samarthan	समर्थन
based	बसे
sahab	साहब
kaha	कहा
kioo	किओ
diye	दिये
bhonk	भोंक
lagu	लागू
vedesh	वेदेश
bhagega	भागेगा
uske	उसके
waha	वाहा
kutte	कुत्ते
bhokega	भोखेगा
acche	अच्छे
aagaye	आगाए
jaise	जैसे
faida	फैदा
bi	बी
wale	वाले
chandigarh	चंडीगढ़
abhitak	अभीतक
sabse	सबसे
bada	बड़ा
maine	मैंने
aj	आज
mahine	महीने
pahle	पहले
gaya	गया
rate	रेट
badhega	बढ़ेगा
yaha	यहा
ulta	उल्टा
reha	रहा
fir	फिर
mahan	महान
dil	दिल
jeete	जीते
gaon	गाँव
bilkul	बिल्कुल
dehat	देहत
mere	मेरे
pahuch	पहुच
kahin	कहीं
sabhi	सभी
malum	मालूम
pta	पता
nhi	न्ही
kahe	कहे
aazad	आज़ाद
tera	तेरा
dekh	देख
harvard	हावर्ड
sharma	शर्मा
kis	किस
ulloo	उल्लू
saakh	साख
mitti	मिट्टी
vikas	विकास
kisi	किसी
samay	समय
sakta	सकता
gayi	गयी
lakh	लाख
carore	करोर
jagah	जगह
lena	लेना
khud	खुद
khushi	खुशी
jis	जिस
humara	हमारा
diwala	दीवाला
nikalne	निकलने
nikaal	निकाल
jayega	जाएगा
bhala	भला
krne	क्रने
wajah	वजह
srijan	सृजन
ujagar	उजागर
janha	जान्हा
tanha	तन्हा
gya	ज्ञा
tamacha	तमचा
vapak	वापक
thai	थाई
bole	बोली
kucch	कुच्छ
hajarcaror	हजर्करोर
rupye	रुपए
banko	बाँको
jama	जमा
huye	हुये
kam	कम
lagaye	लगाये
mitronnnnnnn	मिट्रोन
kara	करा
wali	वाली
aati	आती
phenk	फेंक
koyi	कोई
karke	करके
insaan	इंसान
bhir	भीर
vikash	विकास
mare	मारे
iske	इसके
ghar	घर
mout	मौत
naachegi	नाचेगी
bhuktto	भूक्त्तो
tumko	तुमको
jhatake	झटके
bhikhmanga	भिख्मंगा
bana	बना
tumhare	तुम्हारे
jindagi	जिंदगी
bhar	भर
bheekh	भीख
mangega	मांगेगा
zakhm	ज़ख्म
bhara	भारा
ghaav	घाव
berozgari	बेरोउंगरी
mahila	महिला
suraksha	सुरक्षा
ratio	रेतियो
badgaya	बदगया
chuka	चुका
nahin	नहीं
main	में
bar-2	बार-2
niyam	नियम
badla	बदला
karna	करना
sai	साई
pehla	पहला
budhiman	बुद्धिमान
sochta	सोचता
murakh	मुरख
itne	इतने
dino	दिनो
apko	अपको
yaad	याद
rha	रा
galat	गलत
faisla	फ़ैसला
kisne	किसने
jinka	जिनका
asaliyat	असलियट
chal	चल
yahi	यही
fayda	फायदा
tir	तिर
kahi	कही
naa	ना
jaye	जाये
samhhal	समहाल
mariyega	मरियेगा
misfire	मिस्फीरे
sikhaao	सिखाओ
apne	अपने
bhai	भाई
beda	बेड़ा
gark	गर्क
sirf	सिर्फ
baare	बारे
abhi	अभी
kitne	कितने
aane	आने
baqi	बकी
mantrimahodaya	मंत्रिमहोदया
jeet	जीत
karte	करते
paresani	परसानी
haai	हाई
isse	इससे
aacha	अच्छा
gujrat	गुजरात
milega	मिलेगा
baki	बाकी
dost	दोस्त
jabse	जबसे
lagakar	लगाकर
bar	बार
pada	पड़ा
virus	वाइरस
felane	फेलेने
band	बंद
rahi	रही
bevakoof	बेवकूफ
nai	नाई
banne	बनने
vali	वाली
dikhane	दिखाने
kosis	कोसिस
garibon	गरीबों
qki	क्की
garib	गरीब
parivar	परिवार
bhul	भूल
jaiye	जाइये
kha	खा
samajh	समझ
gai	गई
businessmen	बुसिनेस्में
sarkaar	सरकार
sanjay	संजय
leela	लीला
bhansali	भंसली
laga	लगा
lagte	लगते
boot	बूट
waale	वाले
dekha	देखा
bata	बता
hoon	हूँ
kyunki	क्योंकि
andar	अंदर
baithe	बैठे
peeche	पीछे
ghus	घुस
porbandar	पोरबंदर
apna	अपना
lete	लेते
satta	सत्ता
aakar	आकर
jesi	जेसी
aatankwadi	आतंकवाड़ी
harkat	हरकत
karate	करते
sara	सारा
maal	माल
jese	जैसे
pillo	पीलो
dete	देते
pure	पूरे
lut	लूट
bharat	भारत
kitna	कितना
kala	काला
dhan	धन
aaya	आया
accha	अच्छा
prashna	प्रशना
chillar	चिलर
puccha	पूछा
value	वेल्यू
badh	बढ़
bahut	बहुत
gujaraat	गुजरात
anusaar	अनुसार
iska	इसका
filhal	फिल्हल
hota	होता
dikh	दिख
jitni	जितनी
shayad	शायद
sone	सोने
majdoor	मजदूर
bhukhe	भूखे
soye	सोये
dikhaega	दिखाएगा
kaunse	कौनसे
chaurahe	चौराहे
pe	पे
milenge	मिलेंगे
janna	जन्ना
chahti	चाहती
valo	वालो
alag	अलग
lute	लुटे
goli	गोली
maro	मारो
socho	सोचो
policy	पॉलिसी
tuglaqi	तुगलकी
kaala	काला
saap	साप
phus	फूस
anar	अनार
iss	इस
jao	जाओ
badhali	बढ़ाली
kyoki	क्योकी
aaaj	आज
diwali	दीवाली
saanp	साँप
kade	कड़े
utha	उठा
skta	स्कता
inka	इनका
paise	पैसे
milte	मिलते
inhi	इन्ही
gaddaro	गद्दारों
benakab	बेनकब
karta	करता
mazra	माज़रा
kiske	किसके
safed	सफ़ेद
launde	लॉन्दे
islam	इस्लाम
hindu	हिन्दू
dikhai	दिखाई
deta	देता
ghotala	घोटाला
dikhao	दिखाओ
bhrosa	भ्रोसा
kye	क्ये
hare	हरे
duniya	दुनिया
jate	जाते
karan	करण
abb	अब
nind	नींद
khuli	खुली
jhut	झुत
vakalat	वकालत
chuss	चूस
poori	पूरी
taiyar	तैयार
hawaiyan	हवाइयाँ
udd	उड़
gyi	गी
pad	पड़
chaplusi	चप्लसी
utar	उतर
jaiyega	जाइयेगा
janata	जनता
janardan	जनार्दन
faisala	फ़ैसला
jaldi	जल्दी
sona	सोना
shubha	शुभा
baje	बजे
hamare	हमारे
future	फुत्रे
lagega	लगेगा
jawab	जवाब
uska	उसका
sare	सारे
jit	जीत
mil	मिल
march	मार्च
kitni	कितनी
pareshan	परेशान
jalwa	जलवा
badhta	बढ़ता
beshak	बेशक
puri	पूरी
phla	फ्ला
bhut	भूट
kadam	कदम
rokne	रोकने
vyapariyo	व्यापारियों
iseeliye	ऐसीलिए
humne	हमने
nirdosh	निर्दोष
beta	बेटा
nahee	नहीं
chahiyeh	चाहियह
apni	अपनी
maa	मां
khada	खड़ा
hame	हमें
ginva	जिनवा
jinse	जिनसे
gareebon	गरीबों
lagkr	लगक्र
marne	मरने
alawa	अलवा
pareshani	परेशानी
hoti	होती
ilaj	इलाज
teeke	तीके
yehi	यही
pado	पड़ो
videsh	विदेश
kisan	किसन
tabah	तबाह
notice	नोटिस
bhej	भेज
tang	तंग
garq	गर्क़
rahul	राहुल
baba	बाबा
barse	बरसे
farmer	फाड़मेर
mahoba	महोबा
matar	मातर
kilo	किलो
kaaran	कारण
chunaav	चुनाव
batayenge	बतायेंगे
inko	इनको
jaanta	जानता
kiska	किसका
bike	बाइक
achanak	अचानक
meri	मेरी
nazarein	नज़रें
mahaan	महाँ
bhakton	भक्तो
dhundhne	ढूँढ्ने
lagi	लगी
jinhone	जिन्होने
shahrukh	शाहरुख
khan	खान
insan	इंसान
hogyi	होगी
jaan	जान
chuke	चुके
zimmedar	ज़िम्मेदार
kurte	कुर्ते
babu	बाबू
garibo	गरिबो
fayeda	फाएदा
uthana	उठना
dekhiye	देखिये
feku	फेकु
barbaad	बर्बाद
naam	नाम
huey	हुए
unka	उनका
chowraha	चौड़ाहा
wada	वादा
dhare	धरे
rah	रह
jante	जानते
whale	व्हेल
kaladhan	कालाधन
app	आप्प
netao	नेताओ
bhrashtachar	भ्रष्टाचार
li	ली
bol	बोल
kami	कमी
padha	पड़ा
likhna	लिखना
gyani	ज्ञानी
batao	बताओ
mujhe	मुझे
lagta	लगता
sunder	सुन्दर
paiso	पैसों
badi	बड़ी
rup	रूप
dhire	धीरे
sik	सिक
vyapariyon	व्यापारियों
achha	अच्छा
kijiye	कीजिये
takleef	टकलीफ़
ladkiya	लड़किया
gori	गोरी
jaati	जाती
khatra	खतरा
jatley	जटले
pucho	पूछो
jinki	जिनकी
vision	विज़न
roshni	रोशनी
krri	क्री
dega	देगा
tu	तू
kal	कल
market	मार्केट
itnee	इतनी
bheed	भीड़
asar	असर
khoob	खूब
kasam	कसम
kasoor	कसूर
janaab	जनाब
baant	बाँट
shadi	शादी
zaroor	ज़रूर
bhakt	भक्त
honge	होंगी
humare	हमारे
jeb	जेब
daliye	डलिये
chor	चोर
khtm	ख्त्म
gye	ग्ये
bachi	बची
sidhi	सीधी
sadhi	सधी
kyahi	क्याही
kare	करे
malya	माल्या
adani	अदनी
raimashwira	र्यमांश्वीरा
sabak	सबक
liya	लिया
appko	आपको
apke	आपके
walon	वालों
hona	होना
chayee	छाई
aaplogon	आप्लोगों
chacha	चाचा
saare	सारे
kab	कब
deshvasi	देश्वासी
chhod	छोड़
dono	दोनों
cheezon	चीजों
ayodha	अयोधा
rammandir	राम्मंदिर
denge	देंगे
mai	मैं
aata	आता
kahunga	कहूंगा
zinda	ज़िंदा
mar	मार
gayae	गायए
population	पॉपुलशन
liyae	लियाए
jisme	जिसमें
dikkt	डिकत
aapko	आपको
hogaye	होगाए
aate	आते
notebandi	नोटिबंदी
fyada	फ्यादा
ish	ईश
bohut	बहुत
ghaata	घाटा
shah-zade	शाह-ज़ैदे
shuru	शुरू
crore	करोड
kardi	कर्दी
saansein	साँसें
thoda	तोडा
pappu	पाप्पू
udyogpatio	उद्योगपेटियो
agli	अगली
sabit	साबित
majak	मजक
banate	बनाते
jee	जी
naraj	नाराज़
gaddar	गद्दार
bandi	बंदी
badhai	बधाई
hamaare	हमारे
khali	खाली
hogaya	होगाया
raghu	रघु
ramrajan	रामरजन
amantrana	अमंत्रणा
haay	हाय
tauba	तौबा
machane	मचने
kaali	काली
kamai	कमाई
doob	दूब
mana	माना
anti	एंटी
manayenge	मनाएंगे
carib	करीब
khilaf	खिलाफ
hadd	हद
bhrastachar	भ्रास्ताचार
safaya	सफाया
poora	पूरा
digital	डिजिटल
jise	जैसे
bajariyon	बजरियों
gayee	गये
jitne	जितने
papa	पापा
katke	काटके
bachaye	बचाये
karana	करना
walo	वालों
asan	आसन
saudi	सऔदी
arab	अरब
bechara	बेचारा
bikhari	बिखरी
gaali	गाली
rehta	रहता
dekho	देखो
jashn	जश्न
unn	उन
pariwar	परिवार
bulaya	बुलाया
jaega	जाएगा
jinke	जिनके
mei	मी
majority	मेजोरिटी
unke	उनके
ruk	रुक
jaata	जाता
pass	पास
karaya	कराया
banda	बंदा
kahta	कहता
jarur	जरूर
chalo	चलो
kisse	किस्से
sunte	सुनते
saam	साम
zarur	ज़रूर
dekhe	देखें
jaae	जाए
payi	पायी
jhoot	झूट
batane	बताने
siwa	सिवा
pahad	पहड
pate	पते
gina	जिना
prashansa	प्रशंसा
bajaye	बजाये
mile	मिले
sahi	सही
salute	सालूटे
talaq	तलाक
mahilaye	महिलाये
dikhe	दिखे
salaam	सलाम
bolna	बोलना
dekar	देकर
kasmir	कस्मीर
pakistan	पाकिस्तान
deni	देनी
muslim	मुस्लिम
virodhi	विरोधी
samjhe	समझे
afsos	अफ़सोस
nari	नारी
roop	रूप
mani	मनी
arnab	अर्नाब
bahan	बहन
beti	बेटी
mataram	मातरम
gayenge	गाएंगे
nikah	निकाह
jaha	जहा
kaltak	कल्टक
banehue	बनेहुए
hinduism	हिंदू
upar	ऊपर
bhokalagaye	भोकलगाये
behenji	बेहनजी
haq	हक़
awaaz	आवाज
uthati	उठती
abi	अभी
bharatiyo	भारतियो
phukat	फुकत
zindagi	ज़िंदगी
guzarna	गुज़रना
chahre	चाहरे
jawan	जवान
kanun	कनूँ
bhada	भदा
mehlao	महलाओ
praud	प्रौड
jeeny	जीनी
ley	ले
ga	गा
milta	मिलता
burkha	बर्खा
mahashay	महाशय
wahan	वहाँ
amnesia	अम्नेशिया
jata	जाता
khuda	खुदा
rahmat	रहमत
dahej	देहेज
sati-pratha	सती-प्रथा
dhong	ढोंग
dohra	दोहरा
charitr	चरित्र
saamne	सामने
bolne	बोलने
roka	रोका
sickulars	सिंगकुलर
cheej	चीज
debate	देबतें
jaroorat	जरूरत
karega	करेगा
tukde	टुकड़े
savko	सव्को
chahiye	चाहिए
shariyat	शरीयत
chalne	चलने
ayega	आयेगा
beheno	बेहनो
hifazat	हिफाजत
rasta	रास्ता
banao	बनाओ
samaz	समाझ
lago	लगो
bhaashan	भाषण
jumla	जुमला
whatsapp	व्हेत्सप्प
saqta	सकता
larki	लार्की
jindegi	जिंदेगी
suspension	सस्पेंशन
bara	बारा
kah	कह
manege	मनेगे
jabki	जबकी
aya	आया
umar	उमर
bashirhat	बशिर्हट
kahan	कहाँ
bachaa	बचा
rahey	रहे
samuday	समुद्य
talak	तलक
bandh	बंध
khatre	खतरे
ladke	लड़के
jakr	जाक्र
qubool	क़ुबूल
maang	मांग
bharosa	भरोसा
kyonki	क्योंकि
unhe	उन्हे
biwi	बीवी
jyada	ज्यादा
mulle	मुल्ले
pasand	पसंद
jaatiwaad	जातिवाद
soch	सोच
3talaq	3तलाक
male	माले
aawaz	आवाज़
jahil	जहील
bach	बच
hal	हल
zariye	जरिये
jaj	जाज
pawor	पवर
jae	जाए
full	फुल
khtra	ख्त्रा
mulk	मुल्क
sadak	सड़क
lana	लाना
banakr	बनाक्र
nikala	निकला
warna	वरना
tutega	टूटेगा
murder	मर्डर
acha	अच्छा
murde	मुर्दे
jalane	जलाने
rape	रप
pideeton	पीड़ितों
thodi	थोड़ी
chinta	चिंता
pideet	पीदीत
mahilao	महिलाओ
kariye	करिये
batya	बत्या
bhe	भे
jismey	जिसमें
aprad	अप्रद
dene	देने
jayenge	जाएंगे
karenge	करेंगे
naye	नये
chalu	चालू
jahan	जहाँ
saheb	साहब
bahot	बहोत
jaruri	जरूरी
zamaane	जमाने
mahilaon	महिलाओं
bharpoor	भरपूर
samjho	समझो
bhasan	भासन
chaloge	चलोगे
samasyao	समस्याओ
sudhariye	सुधारिये
karwa	करवा
hamesha	हमेशा
andho	अंधो
paksh	पक्ष
dalil	दलिल
gandhi	गांधी
village	विलेज
kabi	कभी
bahar	बाहर
niklo	निकलो
fikr	फ़िक्र
inki	इनकी
rasm	रस्म
najayaj	नाजयाज
mazak	मज़क
nayi	नयी
lai	लाई
aao	आओ
tbhi	त्भी
dakhl	डाखल
chahte	चाहते
galti	गलती
saza	सज़ा
bhugte	भुगते
aurat	औरत
uski	उसकी
marzi	मर्ज़ी
jan	जान
nah8	नाह8
chahta	चाहता
pati	पति
milni	मिलनी
karegi	करेगी
esko	एस्को
sulza	सुल्झा
aage	आगे
janwr	जनवर
bachake	बचके
insano	इनसानो
rhi	री
dilane	दिलने
kua	कुआ
bade	बड़े
kashmir	कश्मीर
shabd	शब्द
zyada	ज्यादा
chilla	चिल्ला
shaadi	शादी
chahate	चाहते
bolo	बोलो
smriti	स्मृति
irani	ईरानी
baadme	बादमे
doosro	दूसरो
barsaat	बरसात
jihadi	जेहादी
sanghan	संघन
abdul	अब्दुल
itna	इतना
gussa	गुस्सा
kyu	क्यू
behenon	बेहनोन
kon	कों
milne	मिलने
bhakts	भक्त
behen	बेहन
waisi	वैसी
awaj	अवाज
uthayegi	उठायेगी
jin	जिन
marriage	मेरेज
halala	हलाला
farmula	फार्मुला
tumne	तुमने
ukhaad	उखाद
dusre	दूसरे
kehna	कहना
suno	सुनो
najar	नज़र
krna	क्रना
usme	उसमे
dikkat	दिक्कत
hori	होरी
lga	ल्गा
jaayega	जायेगा
laagu	लागू
paas	पास
dekhlo	देखलो
jaane	जाने
gilani	गिलानी
kamjor	कमजोर
unko	उनको
jana	जाना
india	इंडिया
ladai	लड़ाई
rehi	रही
manne	मानने
chala	चला
biti	बीती
tabhi	ताभी
paata	पाता
pain	पेन
samhjo	संहजो
shame	शर्म
bibi	बीबी
liberal	लिबेरल
samjhti	समझती
hogga	हॉगआ
waah	वाह
ghanta	घंटा
pani	पानी
ayye	अय्ये
deti	देती
honne	होन्ने
lawyer	लावायर
patakhe	पतखे
karwate	करवाटे
ladte	लड़ते
kehte	कहते
hinduon	हिन्दुओं
maathe	माथे
likha	लिखा
farji	फ़र्जी
aadmion	आदमियन
kahegi	कहेगी
mulla	मुल्ला
molvi	माल्वी
isko	इसको
jine	जीने
pas	पास
gadbad	गड़बड़
gumrahi	गुमराही
saab	साब
mubarak	मुबारक
aahista	आहिस्ता
waise	वैसे
illegal	इलेगल
khulkar	खुलकर
tataf	टाटाफ
dhol	ढोल
bajate	बजाते
mam	माम
karti	करती
nahy	नाही
hosake	होसके
derahe	देराहे
sambhal	संभाल
mardon	मर्दों
hoi	होई
naaki	नाकी
chitthi	चित्ती
teen	तीन
gharelu	घरेलू
hinsa	हिंसा
bura	बुरा
waja	वाजा
chaye	छाये
agarwal	अग्रवाल
hamara	हमारा
kahna	कहना
britain	ब्रिटेन
burka	बुर्का
uljhe	उलझे
nikalo	निकलो
krta	क्रता
lagate	लगते
chori	चोरी
sajaa	सजा
maarne	मारने
banaya	बनाया
khilaaf	खिलाफ
jyda	जैदा
gore	गोरे
chitte	चित्ते
bhare	भरे
hara	हरा
paan	पान
lagao	लगाव
gandangi	गंदगी
mitane	मिटने
bolotab	बोलोतब
ham	हम
kahenge	कहेंगे
allah	इल्लाह
sansad	संसद
pase	पसे
isliye	इसलिए
bahana	बहना
aasan	आसन
dena	देना
kamal	कमल
maulavis	मौलाविस
awaz	आवाज़
uthate	उठते
azan	आज़न
yaar	यार
sati	सती
pratha	प्रथा
phr	फ्र
bandho	बंधो
invalid	इंवालिड
nuqsan	नुक़्सन
ladies	लेडीज़
kehne	कहने
balki	बल्कि
rakhel	रखेल
hojati	होजती
awaaj	आवाज
sayad	सायाद
sharm	शर्म
kro	क्रो
doston	दोस्तों
jane	जाने
hath	हाथ
pi6e	पी6ए
pargaya	परगया
shantiduto	शांतिदुतो
usiko	उसको
jail	जेल
kharcha	खर्चा
chup	चुप
dia	दिया
keha	कहा
banna	बन्ना
chahati	चाहती
raajniti	राजनीती
roti	रोटी
sakne	सकने
aag	आग
bhayio	भाइओ
tumlogo	तुमलोगो
jinko	जिनको
takat	ताकत
seedhe	सीधे
bitar	बितार
jaoge	जाओगे
mevani	मेवानी
unar	उनर
khalid	खालिद
divided	दीविदेड
tarha	तरहा
typographical	टायपोग्राफिकल
karvane	करवाने
beseeched	बेसीछेड़
aapke	आपके
editor	एडीटर
maharashtra	महाराष्ट्र
tuje	तुझे
padi	पड़ी
dekhana	देखना
aadmi	आदमी
maha	महा
rok	रोक
zalim	ज़ालीम
isi	इसी
mudde	मुद्दे
pratikriya	प्रतिक्रिया
kadi	कड़ी
ninda	निंदा
asliyat	असलियट
khel	खेल
baaki	बाकी
dialogue	डायलॉग
jaani	जानी
jiske	जिसके
seese	सीसे
dusro	दूसरो
gharo	घरो
feka	फेका
dharm	धर्म
sabke	सबके
khol	खोल
kyunke	क्योंके
chura	चुरा
ram	राम
kucchh	कुच्छ
chhodo	छोड़ो
gareebi	गरीबी
mit	मिट
jayegi	जाएगी
daayare	दायरे
dekne	देकने
kub	कब
kalma	कलमा
qubul	क़ुबूल
rajneeti	रजनीति
sudar	सुदार
jawo	जवो
duum	दूम
seedhi	सीढ़ी
poochiye	पूछिये
usne	उसने
bachpan	बचपन
raja	राजा
tab	तब
besharmi	बेशर्मी
makkari	मक्करी
pregnant	प्रेगनेंट
sabko	सबको
maloom	मालूम
avhi	अवही
kbhi	क्भी
uss	उस
boliye	बोलिए
detail	देतेल
ise	इसे
hisab	हिसाब
maulana	मौलाना
fatweh	फत्वह
uney	उने
karey	करे
shariah	शरीअत
kul	कुल
jasodaben	जसोदबेन
leki	लेके
mahabharata	महाभारत
uttar	उत्तर
pradesh	प्रदेश
shaandaar	शानदार
code	कोड
zarye	ज़र्ये
gujarat	गुजरात
praschit	प्रश्चित
karwabe	करवाबे
hindustani	हिन्दुस्तानी
awsar	अवसर
usshme	उसमे
matvate	मतवाते
mahilayo	महिलेयो
sharaph	शराफ
saman	समन
inke	इनकी
intzar	इंज़ार
iski	इसकी
bahu	बहू
chalega	चलेगा
bhaiyya	भैया
gulam	गुलाम
kyoun	क्यूँ
auratei	औरती
samaagri	समाग्री
kanoon	कानून
chinese	चीन
hindi	हिन्दी
tumhara	तुम्हारा
dhamki	धमकी
guru	गुरू
istifa	स्तीफा
jimedar	जिमेदार
behnon	बेहनों
behano	बहनो
azadi	आज़ादी
galla	गल्ला
chlla	छल्ला
aasani	आसानी
faisal	फ़ैसल
sunlte	सुनलते
faisle	फ़ैसले
andh	अंद
bhak	भक
jala	जला
bolte	बोलते
yashodaben	यशोडबेन
akela	अकेला
diyo	दियो
dukaan	दुकान
chalane	चलने
sharia	शरिया
khadak	खड़क
khadakane	खड़कने
khadakati	खड़कती
samaj	समाज
khaskar	खस्कर
shiksha	शिक्षा
hokar	होकर
khalifa	खलीफा
edu	एडू
nhee	न्ही
apki	अपकी
duty	ड्यूटी
behtrin	बेहत्रीन
jisse	जिससे
kharab	खराब
aakr	आक्र
khod	खोद
marjate	मर्जाते
mardete	मर्देते
pesh	पेश
karane	करने
raazi	रानी
mulsman	मूल्समन
ladki	लड़की
chale	चले
kysa	क्य्सा
lgta	ल्गता
asli	असली
dekhi	देखी
bohot	बोहोत
bhadda	भद्दा
khoode	खूड़े
battar	बत्तर
haalat	हालत
rakkha	रक्खा
referendum	रेफ्रेंड
haath	हाथ
rahu	राहु
ketu	केतु
jiski	जिसके
jawaan	जवान
nukkad	नुक्कड़
jaate	जाते
tamatar	तमतर
maarte	मारते
jor	जोर
bolkar	बोलकर
ujad	उजड़
chalte	चलते
sehar	सहर
bane	बने
ghum	घूम
bazaar	बाज़ार
sarkar	सरकार
bida	बीड़ा
majhabi	मझबी
masla	मसला
rajnitik	रजनीतिक
leke	लेके
dukano	दुकानो
taala	ताला
shohar	शोहर
lagti	लगती
abolish	अबॉलिश
mandir	मंदिर
vishay	विषय
maulanas	मौलानस
waqt	वक्त
buddhi	बुद्धि
padh	पढ़
thothli	थोथली
banani	बनानी
taki	तकी
gira	गिरा
budhi	बूढ़ी
jeewi	जीवी
rage	रागा
kuchh	कुछ
talve	ताल्वे
chatne	चटने
astha	आस्था
visay	विसाय
batate	बताते
jashodaben	जशोदबेन
parivaar	परिवार
lenge	लेंगे
baal	बाल
kuritiyan	कुरिटियाँ
bhale	भले
judi	जुड़ी
kuriti	कुरीती
bheja	भेजा
kaminas	कमिनस
kabada	कबाड़ा
satha	सता
saalon	सालों
kuwaaron	कुवारों
taraf	तरफ
jaanoge	जानोगे
bakloli	बकलोली
sibbal	सिब्बल
esi	एसी
baatein	बातें
votes	वोटस
sudhar	सुधार
raftaar	रफ़्तार
badegi	बढ़ेगी
re	रे
banti	बंती
aapki	आपकी
chaiye	चाइये
sala	साला
vi	वि
karu	करू
khayu	खायू
sal	साल
hamdardi	हमदर्दी
btaye	बताये
dekr	देक्र
besahara	बेसहारा
dakhal	दाखल
dohre	दोहरे
rishta	रिश्ता
harram	हर्रम
chate	चते
dur	दूर
trupti	तृप्ति
desai	देसाई
magne	मेगने
zoothi	झूठी
dange	देंगे
ayi	आयी
fursat	फ़ुर्सत
doosri	दूसरी
kitaabein	किताबें
jafar	जफर
jada	जड़ा
rakhiye	रखिये
mazhab	मजहब
atyachar	अत्याचार
ibadat	इबादत
ghumne	घूमने
khusiya	खुसिया
manaa	मना
jaisi	जैसी
bolenge	बोलेंगे
delhi	दिल्ली
kaafi	काफ़ी
mauka	मौका
bhejo	भेजो
haar	हार
mullah	मुल्ला
beghum	बेग़म
chakar	चकर
payega	पायेगा
talaak*	तलाक*
janam*	जनम*
lijiye	लीजिये
mard	मर्द
abandon	अबंदोन
minister	मिनिस्टर
mahilaoke	महिलाओके
honewala	होनेवाला
kabse	कबसे
niyat	नियत
kay	के
bola	बोला
tenure	तेनूरे
karwaya	करवाया
banakar	बनाकर
sachch	सच्च
musalmaan	मुसलमान
auroton	रोतोन
package	पऐकेज
kiyaa	किया
auraton	औरतों
kyaa	क्या
paap	पाप
jay	जय
mukti	मुक्ति
ajadi	अज़ाड़ी
sochna	सोचना
yahan	यहाँ
dikhawa	दिखावा
tripal	त्रिपाल
palegi	पलेगी
koun	कौन
bechari	बेचारी
paksitan	पक्सीताँ
premi	प्रेमी
vahe	वाही
shreeman	श्रीमान
debat	देबत
kase	कसे
yuva	युवा
rojgar	रोज़गर
kaun	कौन
taiyaar	तैयार
mahengayi	महँगाई
gundagardi	गुंडगर्डी
jamke	जमके
duba	डूबा
vasuli	वसुली
vijay	विजय
prapt	प्रप्त
satr	सत्र
mein14	मैं14
parit	परित
kumar	कुमार
central	सेंट्रल
sahyog	सहयोग
ichha	इच्छा
technology	टेक्नोलॉजी
vyapar	व्यापार
badhao	बढ़ाओ
apnao	अपनाओ
vidhan	विधान
sabha	सभा
leta	लेता
ragistred	रजिस्ट्रीड
dubara	दुबारा
ragistration	रजिस्ट्रेशन
naya	नया
aayega	आयेगा
kaat	काट
shyad	श्याद
ubhre	उभरे
nazar	नज़र
chaal	चाल
yojna	योजना
file	फाइले
gang	गंग
gaaliyon	गालियों
dhyaan	ध्यान
rakhna	रखना
saari	सारी
gaaliyaan	गालियाँ
honi	होनी
chaahiye	चाहिए
jawaabdaar	जवाब्दार
sukr	सुक्र
varna	वरना
jatiyan	जातियाँ
bhartiy	भारतीय
ghosit	घोसित
huva	हुवा
gala	गला
kafi	काफ़ी
mehanat	मेहनत
trauma	ट्रुमा
goonge	गूँगे
single	सिंगल
chalti	चलती
khabar	खबर
mano	मानो
issur	इससुर
atak	अटक
ache	अचे
jhoothe	झूठे
prcharak	प्रचरक
achi	अची
baitor	बैटर
sote	सोते
sapne	सपने
satata	सताता
eske	एस्के
sharam	शरम
bhako	भको
far	फर
dhandha	धंधा
dhyan	ध्यान
rakh	रख
barabar	बराबर
ghinone	घिनोन
mooh	मूह
achhe	अछए
aiyyar	ऐय्यर
deshdroh	देशद्रोह
china	चीना
maaibap	माइबाप
manta	मानता
kautilya	कौटिल्य
baarein	बारें
chutiyaape	चुटियापे
jaad	जाड़
bhoole	बोले
abe	अबे
ghere	घेरे
paida	पैदा
gabbar	गब्बर
paresan	परसन
lout	लौट
phool	फूल
baith	बैठ
jaa	जा
policies	पॉलिसी
thaa-aap	था-आप
karwalo	करवालों
hissa	हिस्सा
jamkar	जमकर
adarsh	आदर्श
kia	किया
zaroorat	ज़रूरत
faayeda	फायेदा
himachal	हिमाचल
sarkari	सरकारी
suvidhaon	सुविधाओं
laya	लाया
jaaye	जाये
suvdhayen	सुव्धाएं
registration	रजिस्ट्रेशन
saaf	साफ
kharede	खरेड़े
jasaje	जसजे
nateejatan	नतीजतन
bakaam	बकाम
bataye	बताये
asmaji	असमाजी
bitha	बिता
khana	खाना
khila	खिला
visheshagyo	विशेषग्यो
salaah	सलाह
dhanyabad	धन्याबाद
viswas	विश्वास
banaye	बनाये
aarahe	आराहे
mahapurush	महापुरुष
dikhaye	दिखायें
bache	बच्चे
jayege	जाएँगे
mili	मिली
bhagat	भगत
humse	हमसे
bahaane	बहाने
rajasv	राजस्व
badhaana	बढ़ाना
chaahte	चाहते
tarikh	तारीख
milli	मिली
gaan	गान
gaane	गाने
rehne	रहने
bhalayee	भलाई
2baar	2बार
bhugat	भुगत
ailaan	ऐलान
vaise	वैसे
seedha	सीधा
reham	रहम
ahmedabad	अहमदाबाद
reshuffle	रेशुंफले
biryani	बिरयानी
mehengi	मेहेंगी
nil	नील
modiye	मोदिये
sasta	सस्ता
rajya	राज्य
paving	पविंग
raj	राज
khub	खूब
maze	मेज़
kat	कट
sasti	सस्ती
wheelar	व्हीलार
jhanda	झण्डा
gada	गड़ा
apka	अपका
paya	पाया
hmare	हमारे
lgane	ल्गने
vyavastha	व्यवस्था
durust	दुरुस्त
nikalsakte	निकलसकते
manmani	मनमानी
jaarahe	जाराहे
mangte	मांगते
chutiya	चुटिया
hijab	हिजाब
karoge	करोगे
huwa	हुवा
chiz	चिज़
jald	जल्द
bhatkaya	भटकाया
kisika	किसीका
cheeno	छीनों
patrol	पट्रोल
lao	लाओ
humari	हमारी
zeb	जेब
garibonka	गरीबोंका
mantriji	मंत्रिजी
diesel	डीझेल
vasooli	वसूली
jaitley	जैन्य्ले
hata	हटा
batayegi	बताएगी
gyan	ज्ञान
badha	बढ़ा
hike	हाइके
bacha	बचा
kripya	क्रीप्या
khatrnak	खत्र्नक
dukandaro	दुकंदरों
aapaka	आपका
bhaisaahab	भऐसाहब
usse	उससे
bhech	भेच
khayi	खाई
hataiye	हटाइये
mayne	माईने
develop	डेवलप
dhanyavad	धन्यवाद
aab	आब
behatar	बेहतर
notebandhi	नोटिबंधी
mehenga	मेहँगा
gayaa	गया
slab	स्लैब्
chodh	छोड़
maaf	माफ़
maare	मारे
poore	पूरे
paayi	पायी
sekadon	सेकदों
vyapari	व्यापारी
congressi	कांग्रेसी
vyavshtha	व्यवष्ठा
kamaai	कमाई
avsar	अवसर
chuuk	चूक
jaayengey	जायेंगे
galiyaan	गलियाँ
tiwari	तिवारी
muhse	मुहसे
berojgari	बेरोज़गरी
rahen	रहें
srajan	सरजन
chhodkar	छोड़कर
chakkar	चक्कर
kitno	कितनों
berojgar	बेरोज़गर
karneke	करनेके
maafi	माफ़ी
maangi	मांगी
gun	गुण
loot	लूट
jetali	जेताली
achchha	अच्छा
badhte	बढ़ते
la	ला
bhaiya	भैया
bilaspur	बिलासपुर
shehar	शहर
dhayan	धायान
drainage	ड्रैनेज
ghatiya	घटिया
tere	तेरी
padhke	पढ़के
bhasa	भासा
sikhata	सिखता
baniya	बनिया
kursi	कुर्सी
urja	ऊर्जा
niraasha	निराशा
ayenge	आयेंगे
charges	चार्गास
zara	ज़ारा
kaamo	कामो
unnati	उन्नति
bolta	बोलता
isilye	इसिली
koya	कोया
paa	पा
panama	पनामा
paradise	परडायस
amitabh	अमिताभ
raste	रास्ते
rehkar	रहकर
mazboot	मजबूट
safal	सफल
koshish	कोशिश
asafal	असफल
aase	आसे
jeetenge	जीतेंगे
ek-do	एक-दो
kharido	खरीदो
bewkuf	ब्युकुफ
samajhte	समझते
prayogshala	प्रयोगशाला
rakhe	रखे
huaa	हुआ
role	रोल
aaplogo	आप्लोगो
bekaar	बेकार
ambani	अंबनी
atha	एथा
kishi	किशी
batay	बताय
mahgai	महगाई
thamne	थामने
rajneta	रजनेता
rokna	रोकना
mumbai	मुंबई
bhencho*	भेंचो*
unthinkable	उन्तींकबल
rahegi	रहेगी
fekte	फेकते
raaste	रास्ते
aankhon	आँखों
dhaara	धारा
nikli	निकली
chai	चाय
nam	नम
rakhenge	रखेंगे
masoom	मासूम
zahan	ज़हन
ina'am	इना'आम
marodne	मरोड़ने
bewakufi	बेवाकूफ़ी
matalb	मतल्ब
juthi	जुती
khane	खाने
bhaav	भाव
kapil	कपिल
pagal	पागल
pakda	पकड़ा
actor	एक्टर
sadharan	साधरण
manushya	मांनुंष्य
barish	बारिश
bharne	भरने
aakhri	आखरी
tareekh	तरीख
aake	आके
lagane	लगने
khujli	खुजली
keeda	कीड़ा
daal	दाल
mango	मैंगो
madir	मदिर
aah	आह
jitna	जितना
chahe	चाहें
tooh	तूह
mahgain	महगेन
sochiye	सोचिये
khap	खाप
jinda	जिंदा
lagayegi	लगाएगी
wajha	वाझा
japan	जापान
ludhiana	लुधियाना
vasoolna	वसूलना
meditation	मेडिटेशन
padega	पड़ेगा
chhota	छोटा
bhatka	भटका
neta	नेता
ni	नि
ekdam	एकदम
samne	सामने
rote	रोते
marr	मार
kisko	किसको
dala	डाला
base	बसे
bechta	बेचता
unki	उनकी
choti	छोटी
si	सी
rupee	रुपए
latak	लटक
usko	उसको
utilise	यूटिलिसे
bataiyenge	बताइयेंगे
kangi	कांगी
doremon	डॉरेमन
nautanki	नौतंकी
tha	था
jayenga	जायेंगा
badlo	बदलो
waje	वजे
uspar	उसपर
lelo	लेलो
police	पुलिस
afsar	अफ़सार
rishwat	रिश्वत
mange	माँगे
industry	इंडस्ट्री
kise	किसी
rokh	रोख
yah	यह
samjhaye	समझाए
matlab	मतलब
tatti	तत्ती
dwara	द्वारा
kid's	किड'स
padhai	पढ़ाई
gaddhe	गड़ए
pa	पा
socha	सोचा
sochalay	सोचलय
mehngai	मेहंगाई
manmohan	मनमोहन
boye	बोये
fasal	फसल
krrhe	कृहे
haikaat	हैकात
doge	दोगे
shi	शी
nahayenge	नहाएंगे
aamdani	आमदनी
haadsa	हाड़सा
farak	फ़रक
lootna	लूटना
cheezein	चीजें
ane	आने
wakai	वकाई
saste	सस्ते
aamjanta	आमजनता
maangle	मांगल
sujhaav	सुझाव
tau	ताउ
khai	खाई
kharabi	खराबी
lagaya	लगाया
buzurg	बुज़ुर्ग
dubo	डुबो
aana	आना
mushkil	मुश्किल
thik	ठीक
kii	की
thappad	ठप्पड
darr	दर
aadhe	आधे
ratne	रत्ने
lagne	लगने
andha	अंधा
teri	तेरी
waat	वाट
lagadi	लगड़ी
tarkki	तरकी
krte	क्रते
ghatya	घाट्या
fesle	फेसले
pareshaniyon	परेशानियों
ajkal	अजकल
hisse	हिस्से
khata	खाता
peeta	पीता
ata	आता
drama	ड्रामा
lane	लाने
vese	वैई
bharvane	भरवाने
sabki	सबकी
katne	कटने
samjh	समझ
khajane	खजाने
meharbani	मेहरबानी
pat	पट
fatake	फटके
die	दिए
smajh	स्मझ
lgake	लगाके
aarthik	आर्थिक
halat	हालत
sector	सेक्टर
majabuti	मजबूती
pradhan	प्रधान
krega	क्रेगा
giyaan	गियाँ
hie	हिए
naahi	नाहीं
ganith	गनीथ
aakshron	आक्ष्रों
giyan	गियान
aapkotho	आपकोठो
baten	बातें
aachi	आची
lagthi	लगती
irshad	इरशाद
sadi	सदी
bdi	बदी
disaster	दिसस्टर
aayi	आयी
hamla	हमला
majbur	मजबूर
tajmahal	ताजमहल
muddo	मुद्दो
chipa	छिपा
baja	बजा
bajayegi	बजाएगी
baithee	बैठी
item	आइटम
raashan	रासण
sar	सर
chadti	चढ़ती
harne	हरने
modernising	मॉडरनीइंग
padti	पड़ती
accho	अच्छो
akal	अकल
samajhne	समझने
roz	रोज़
bottle	बोतल
sugam	सुगम
suvidha	सुविधा
pehchan'	पहचान'
agarbatti	अगरबत्ती
pooja	पूजा
sadhana	साधना
taqleef	तकलीफ
waali	वाली
jara	जरा
aankhe	आँखे
khul	खुल
phle	बले
gabbarsingh	गब्बरसिंह
hasi	हसी
laagoo	लागू
lagbhag	लगभग
kahte	कहते
vinas	विन
kale	काले
wiprit	विप्रित
diologue	डायोलॉग
bechare	बेचारे
chutia	चुटिया
jumle	जुमले
julus	जुलस
niklega	निकलेगा
hawai	हवाई
batein	बतें
dubegi	डूबेगी
zimadar	ज़िमदर
khulla	खुल्ला
chahal	चहल
pahal	पहल
vat	वाट
atal	अटल
jodenge	जोड़ेंगे
tarike	तरीके
lagoo	लागू
karneko	करनेको
asal	असल
maqsad	मकसाद
bhatkana	भटकना
gotalo	गोटेलो
rakhi	राखी
khus	खुस
isss	इस
khardine	खार्दिन
paddh	पद्ध
chalta	चलता
deshwasiyo	देश्वासीयो
hardik	हार्दिक
jam	जम
dikhaneki	दिखनेकी
jordaar	जोरदार
bussiness	बसिनेस
maan	मान
preshani	प्रेशनी
rakhte	रखते
kinara	किनारा
karz	कर्ज़
lootne	लूटने
khola	खोला
kisaano	किसानों
min	मीन
banswara	बान्सवारा
indeed	इंदीद
chamcho	चमचो
kahein	कहें
sabsey	सबसे
hotey	होते
vajah	वजह
pyar	प्यार
holsale	होल्सले
doosre	दूसरे
noida	नोएडा
faltu	फलतू
hashtags	हष्टग्स
mehenge	मेहेंगे
agaye	अगाए
baaton	बातों
aadha	आधा
koe	कोए
aadh	आढ़
suna	सुना
ramudev	रामुदेव
neutrality	न्यूट्रालिटी
taza	ताज़ा
misaal	मिसाल
aapk	आपक
tarif	तारीफ
gadi	घड़ी
bangla	बांगला
chhote	छोटे
dukandar	दुकंदर
unpar	उनपर
shivalay	शिवालय
general	जनरल
peso	पेसो
boriya	बोरिया
unhke	उन्ह्के
khuch	खुच
bechne	बेचने
pila	पीला
shamil	शामिल
generations	जनेरेशन्स
keh	कह
chole	कोले
chilli	चिल्ली
potato	पोटेटो
daaru	दारू
farsan	फार्सन
kiski	किसकी
patri	पत्री
jayengi	जायेंगी
rahega	रहेगा
business	बुसिनेस
lakho	लाखों
kahiyye	कहिये
dikhaiyye	दिखाइये
manana	मानना
aavaashyak	आवाश्यक
banana	बनाना
gareeb	गरीब
samza	समझा
rupiya	रुपिया
rahat	राहत
saral	सरल
hasmukh	हसमुख
rulate	रुलाते
daya	दया
baap	बाप
bullet	बुलेट
zaruri	ज़रूरी
marrati	मर्रती
achchaa	अच्छा
namaskar	नमस्कार
hate	हटे
khokla	खोक्ला
margin	मार्जिन
badhadi	बढ़ड़ी
sale	सले
giri	गिरी
baari	बारी
bharta	भरता
bharna	भरना
padta	पड़ता
laaye	लाये
bharo	भरो
agle	अगले
bande	बंदे
bhari	भारी
katega	कटेगा
barsun	बारसून
leekho	लीखो
launched	लॉन्चेड
saala	साला
ati	अति
samajhna	समझना
zada	ज़ैदा
bachoge	बचोगे
saajish	साजीश
bachha	बच्चा
draa	द्रा
betha	बेथा
hawaa	हवा
dali	डाली
mehangha	मेहनगा
vyaapaar	व्यापार
arun	अरुण
sambhavana	संभवना
samjana	समजना
samjavo	समझाओ
devanagari	देवनागरी
btana	बताना
samjha	समझा
des	देस
sandas	संदा
krni	क्रनी
pdti	पती
jaankari	जानकारी
jyadatar	ज्यादातर
dijie	दीजिए
dheere	धीरे
jagha	जाघा
laati	लाती
bachchan	बच्चन
ambassador	एम्बैसडर
sach	सच
aadhi	आधी
vale	वाले
likhne	लिखने
phele	पहले
utna	उतना
mehnga	मेहँगा
goshna	गोशना
roj	रोज
badlam	बदलम
mokuf	मोक्फ
vypari	व्यपारी
chillayege	चिल्लायेंगे
rakhne	रखने
pahale	पहले
seena	सीना
pit	पिट
badalaw	बदलऑ
khaak	खाक
badega	बढ़ेगा
mauke	मौके
kafan	कफन
kharidne	खरीद्ने
nabj	नब्ज
tatol	टाटोल
ilaaz	इलाज
valve	वाल्व
kholne	खोलने
sachi	शची
bhakti	भक्ति
loota	लूटा
zyada-se-zyada	ज्यादा-से-ज्यादा
anpadh	अनपढ़
lalu	लालू
prasad	प्रसाद
bataiye	बताइये
samadhan	समाधान
ghata	घटा
launch	लॉन्च
chage	चागे
lagata	लगता
bulayee	बुलाय्
aajkal	आजकल
kaunsa	कौनसा
ghataya	घटाया
ispar	इस्पार
intezaar	इंतज़ार
chahane	चाहने
kyon	क्यों
unpe	उनपे
bore	बोर
pawan	पवन
kheda	खेड़ा
sarvamanya	सर्वमांन्य
rasatal	रसतल
puchh	पुछ
subah	सुबह
rahan	रहण
lega	लेगा
aari	आरी
rakhni	रखनी
yaane	याने
paagal	पागल
guzare	गुज़रे
aukaat	औकात
maidaan	मैदान
durdarshita	दुर्दर्शीता
baji	बाजी
dum	दुम
faye	फाए
jawani	जवानी
dikhayenge	दिखाएंगे
gazab	गज़ब
badhe	बढ़े
badhae	बढ़ए
lalach	ललच
chije	चीजे
aayegi	आयेगी
bhadkana	भड़कना
jetli	जेटली
ahya	आह्या
jaysa	जैसा
sifarsh	सिफर्श
syllabus	सिलेबस
padna	पड़ना
era	एरा
living	लिविंग
gaanja	गांज
peene	पीने
naubat	नौबत
samba	संबा
khao	खाओ
khilaoo	खिलाऊ
khaane	खाने
tahnkfully	तहनक्फुली
apnhi	अपन्ही
rajniti	रजनीती
chamkao	चमकाओ
vasta	वास्ता
smjhkr	स्मक्र
nasamajh	नासमझ
surat	सूरत
jayada	जयदा
dukhi	दुखी
sochne	सोचने
target	टारगेट
chemist	केमिस्ट
puchho	पूछो
dawa	दवा
sanitary	सनितारी
dushmani	दुश्मनी
chaie	चाए
disel	डिसेल
eksaal	एकसाल
bataya	बताया
upgrade	उपग्रेड
via	विया
kyuki	क्युकी
mangenge	माँगेंगे
jimmewar	जिम्मेवाड़
bazari	बाजारी
vendor	वेंडर
non	नॉन
ashok	अशोक
gehlot	गहलोट
naare	नारे
jankari	जानकारी
robust	रोबस्ट
karod	करोड़
abhiyan	अभियन
fayada	फ़ायदा
muze	मुझे
kachra	कचरा
fenkne	फेंकने
adhyaye	अध्याय
bhikari	भिखारी
jannat	जन्नत
rishab	रीशाब
deke	देके
wasul	वसूल
sri	श्री
leye	लेये
takla	तकला
mehanga	महँगा
mantri	मंत्री
bhali	भाली
bhanti	भाँति
jinhe	जिन्हे
2%doosro	2%दूसरो
bhaiyon	भाइयों
karunga	करूँगा
jaunga	जाऊँगा
hisaab	हिसाब
saushalay	सौशलय
kama	कामा
badhiya	बढ़िया
leli	लेली
dimag	दिमाग
available	अवैलेबल
mazedaar	मज़ेदार
mene	मैने
unhone	उन्होंने
nehi	नेही
thode	थोड़े
chandi	चांदी
chammach	चम्मच
milti	मिलती
dhoondho	ढूँढो
pocket	पॉकेट
aas	आस
wagerah	वाजरह
inhone	इन्होने
mehnge	मेहँगे
dekhna	देखना
karib	करीब
ghante	घंटे
aye	आये
nirasha	निराशा
mahol	महोल
sune	सुनें
charge	चार्ज
halla	हल्ला
macha	मचा
edit	एडिट
sabne	सबने
dal	दल
pakti	पक्ती
tujhse	तुझसे
distribute	डिस्ट्रीब्यूट
jarurat	जरूरत
padne	पड़ने
jutane	जुताने
distant	डिस्तेंट
jaun	जाऊँ
dunga	दूँगा
local	लोकल
shrahan	श्रहण
rakiye	रकिये
samdari	संदरी
chaheya	चाहेया
kambakhat	कंबखत
kehta	कहता
sambhala	संभाला
tabse	तबसे
dharna	धारना
hao	हाओ
samajhme	समझ्में
engineer	इंजीनियर
chhate	छते
acchi	अच्छी
gaono	गाओनो
roti-sabhi	रोटी-सभी
kahon	कहों
aabaadi	आबादी
sapna	सपना
pel	पेल
calendar	कैलेंडर
khaate	खाते
samjhaaye	समझाये
jaisay	जैस्य
unkay	उनक्य
ruppai	रुप्पई
padnewala	पड़नेवाला
magar	मगर
gareebo	गरीबो
middle	मिडिल
ameer	अमीर
idli	इडली
ghee	घी
daru	दारू
pine	पीन
baate	बातें
pdega	पड़ेगा
protsahit	प्रोत्साहित
ajj	अज्ज
bolke	बोल्के
chlana	क्लेना
aisi	ऐसी
paye	पाये
bacche	बच्चे
dinon	दिनों
isme	इसमें
loktantra	लोकतंत्र
bhook	भूक
chhoro	छोरो
purane	पुराने
parha	परहा
parh	पढ़
ksi	कसी
sukhi	सुखी
jyegi	ज्येगी
revolution	रिवॉल्यूशन
indian	इंडियन
likh	लिख
marre	मारे
cigratte	सिग्रट
rone	रोने
dikhne	दिखने
kamaate	कमाते
hamein	हमें
hamari	हमारी
guarantee	गारंटी
chota	छोटा
bda	बड़ा
bhedbhav	भेदभव
sub	सब
manate	मानते
jamane	जमाने
jesus	जीसस
milate	मिलते
dosre	दोसरे
chalayega	चलाएगा
gappe	गप्पे
humaara	हमारा
niwaala	निवाला
chahye	चाहये
sharaab	शराब
hospital	हॉस्पिटल
yehaan	यहान
direct	डाइरेक्ट
netaon	नेताओं
faila	फैला
share	शारें
swagat	स्वागत
rastra	रास्त्र
itnaa	इतना
zyaadaa	ज़्यादा
rahaa	रहा
kaa	का
rollout	रोलौट
pehley	पहले
karney	करने
bhaag	भाग
baarish	बारिश
bhagwan	भगवान
humein	हमें
zama	जमा
vayapriyo	वयप्रियो
udyogo	उद्योगो
abishek	अबिषेक
wohi	वही
kejriwal	केजरीवाल
smjhiye	स्म्झिये
intezqr	इंतेज़्क़्र
samajhni	समझनी
motivate	मोतीवते
karsaktay	कर्सक्तय
jaano	जानो
maano	मानो
jhaant	झाँत
bhr	भ्र
sanyog	संयोग
geeta	गीता
adhyaay	अध्याय
aadarniya	आदरनिया
pradhanamntri	प्रधनऑन्त्री
yani	यानी
yug	युग
aadharshila	आधार्शीला
chasme	चसमें
shamelessly	शामिलेसली
gyaan	ज्ञान
federalism	फ़ेडेरलिम
humen	हमें
adhik	अधिक
taqat	ताकत
kota	कोटा
krege	क्रेंगे
samazhdari	समज़हदारी
likhta	लिखता
muskile	मुश्किले
bhage	भागे
director	डाइरेक्टर
muskil	मुश्किल
behtreen	बेहत्रीन
bihariyo	बिहारियों
sadma	सदमा
mudi	मुड़ी
khoon	खून
daalna	डालना
saath(60)	साथ(60)
zande	ज़ैंडे
gaade	गाड़े
bhuk	भूक
naan	नान
dard	दर्द
bajege	बजेंगे
pranab	प्रणब
mukherjee	मुखर्जी
bajana	बजना
chaahe	चाहें
pole	पोल
fans	फंस
gowrakshak	गोव्रक्षक
dushman	दुश्मन
bahoot	बहूत
nafarat	नफरत
pyara	प्यारा
janam	जनम
_swagat	_स्वागत
udeshya	उदेश्या
aagye	आज्ञे
saar	सार
kissi	किस्सी
kai	कई
rehte	रहते
manti	मांती
pythagoras	पैथागोरस
sudhaar	सुधार
sanmbhav	सन्म्भव
badlaav	बदलाव
sadno	सदनो
manjuri	मंजुरी
pehale	पहले
bhashan	भाषन
maangne	माँगने
malini	मालिनी
khamakha	खमाखा
neend	नींद
samjhana	समझाना
jeisa	जेईसा
sacha	सच्छा
anjaane	अनजाने
karlo	कार्लो
charcha	चर्चा
rahein	रहें
milaga	मिलागा
khamosh	खामोश
raaiyta	राइय्ता
dalo	डालो
behan	बहन
hisa	हिसा
indies	इंडीज
baccho	बच्चो
dhoni	धोनी
kharid	खरीद
sabziyaan	सब्ज़ियाँ
saamaan	सामान
bikash	बीकाश
pherna	फेरना
adat	आदत
nsi	न्सी
maarenge	मारेंगे
jaaoge	जाओगे
karcha	करचा
kahaan	कहाँ
daam	दाम
raajneeti	राजनीति
piyakadd	पीपकद
anpad	अनपद
maalum	मालूम
banata	बनाता
manaya	मनाया
shaamil	शामिल
aatankiyon	आतंकियों
faansi	फांसी
karwane	करवाने
bhagane	भगने
dukan	दुकान
hartal	हरताल
kisano	किसानो
anaj	अनाज
vahi	वही
chaape	चापे
bichaye	बिछाये
dauda	दौड़ा
bhavya	भव्य
samaroh	समारोह
technical	टेक्निकल
taiyyar	तैयार
darindo	दरिंदों
sahir	साहिर
lodhi	लोधी
phelay	पहले
pakistani	पाकिस्तानी
sachay	सचय
google	गूगल
bagair	बगैर
dekhay	देखे
sazaa	सज़ा
ulemaa	उलेमा
nazdeek	नज़्दीक
bazu	बाज़ू
taang	टांग
katna	काटना
haat	हाट
kaatwa	काटवा
mardaangi	मर्दानगी
ktwa	क्तवा
beech	बीच
latka	लटका
phaansi	फाँसी
satttaaa	सत्ता
bhrast	भ्रास्त
raaj	राज
gangrape	गंगरेप
loootmaar	लूटमार
maarna	मारना
peechdi	पीछ्दी
jaatio	जातियो
maarnaa	मारना
bhed	भेद
humaari	हमारी
ektaa	एकता
letti	लेट्टी
balo	बालो
saja	सजा
gale	गली
betiyo	बेटियों
hariyana	हरियाना
dikhta	दिखता
bikta	बिकता
haryana	हरियाणा
bachiyun	बचियूँ
odisha	ओदिशा
ander	अंडर
bhejte	भेजते
odia	ओड़िया
mallab	मल्लभ
nirbhaya	निर्भय
bani	बनी
saboot	सबूत
shambhu	शंभू
regar	रेगर
bikau	बिकाउ
shambhulal	शम्भुलाल
ragar	रागर
bahen	बहं
afrajul	अफरजुल
men	में
nafrat	नफरत
jahe	जहे
samajwadi	समजवाडी
gayatri	गायत्री
aayesha	आयेशा
porki	पोर्की
jhappi	झप्पी
raise	रायसे
agree	एग्री
surakshit	सुरक्षित
inch	इंच
chaati	छाती
achar	आचार
dabane	दबने
togadia	टोगड़िया
gayab	गयब
hatti	हत्ती
tamasha	तमाशा
marital	मेरितल
kanjar	कंजर
kutay	कुट्य
kerwa	करवा
dhondtay	ढोंदतय
kuda	ख़ुदा
safai	सफाई
abhiyaan	अभियाँ
upaay	उपाय
gandi	गंदी
mansikta	मानसिकता
vichaar	विचार
gandagi	गंदगी
dimaag	दिमाग़
mitaee	मिटाई
goliyaan	गोलियाँ
son	सोन
intezar	इंतज़ार
ussi	उसी
bhatkane	भटकने
togadiya	टोघड़िया
miya	मियाँ
ghussa	घुस्सा
kid	किड
peshaver	पेशावर
pathano	पठानो
andolan	आंदोलन
kaisa	कैसा
sasan	ससन
samane	समने
ekjudge	एक्जुज
maut	मौत
puchne	पूछने
bacho	बचो
channa	चन्ना
mereya	मेरेया
gao	गाओ
kardo	करदो
taisi	तैसी
suhag	सुहाग
bolegi	बोलेगी
patrakaar	पत्रकार
betiyan	बेटियाँ
vichlit	विचलित
bachiyon	बचियों
antaraatma	अंतरात्मा
betiyon	बेटियों
khaas	खास
lab	लब
rapist	रपिस्ट
silai	सिलाई
machine	मशीन
bhadawe	भदावे
lagataar	लगतार
ladkiyon	लड़कियों
haivaniyat	हैवनियत
manak	मानक
bhalai	भलाई
uthaye	उठायें
banaiye	बनाइये
darindee	दरिंदी
aisaa	ऐसा
tharthara	थार्थरा
milkar	मिलकर
jbki	ज्बकी
qanoon	क़ानून
smjhna	स्मझना
kynki	क्यंकी
shikaar	शिकार
khatara	खतरा
betiyoon	बेटियों
badgaye	बदगए
jhukne	झुकने
sharminda	शर्मिंदा
chuna	चुना
hamirpur	हमीरपुर
kand	कंड
sihar	सिहर
rapists	रपिस्ट
adheen	अधीन
1saal	1साल
abtak	अब्य्टक
anjaam	अंजाम
humaare	हमारे
sakht	सख्त
didi	दीदी
jaage	जागी
mundwa	मुंडवा
hatkr	हटक्र
niyamit	नियमित
rajye	राज्ये
meine	मैने
nikami	निकमी
char	चार
mamle	मामले
aaise	आइसे
bhand	बाँध
anchor	एंचोर
karayenge	कराएंगे
enpar	एनपर
shaq	शक
bhaisab	भऐसब
postar	पोस्टर
dahal	दहल
vayvastha	वायवस्था
lachar	लाचर
chooki	चूकी
leziye	लेज़िये
uspe	उसपे
bhiii	भी
haii	ही
faashi	फ़ाशी
saazaa	साजा
mini	मिनी
chaiyee	चाइये
huu	हुं
khaatar	खाटर
aatama	आतमा
chupi	छुपी
tolo	टोलो
behtareen	बेहतरीन
batai	बताई
aqal	अक़ल
mutabiq	मुताबिक
chaurahey	चौराहे
raip	रायप
hila	हिला
caindal	कैंडल
khi	खी
mata	माता
ajeeb	अजीब
karnataka	कर्नाटक
rajyo	राज्यो
bachhe	बच्चे
khattar	खट्टर
slogan	स्लोगान
padhao	पढ़ाओ
honay	होने
nikamba	नीकम्बा
baysarm	बेसर्म
dekhtay	देखते
banwaiye	बनवाइये
bachhiyon	बच्चियों
hain-	हैं-
karthe	करते
phansiya	फाँसिया
dalni	दलनी
leken	लेखेन
jub	जुब
tuk	तुक
taleem	तलीम
hasil	हासिल
tub	तूब
instant	इंस्टेंट
pucha	पूछा
kasur	कसुर
pakarlia	पाकारलिया
saaray	सारे
bachon	बचों
humor	ह्युमर
majboor	मजबूर
gajar	गजर
manu	मनु
rapisto	रपिस्तों
modiki	मोदीकी
kahttar	कहत्तर
dasi	दासी
bachan	बचन
kawita	कविता
karoon	करूँ
sambedna	समेदना
puchhta	पूछ्ता
dedbody	देडबॉडी
bhag	भाग
bacchao	बच्चाओ
sabhya	सभ्य
languge	लंगुगे
kiyun	कियूँ
maata	माता
sewa	सेवा
karwao	करवाओ
gaumaa	गोमा
waloun	वालूँ
saale	साले
israel	इस्राइल
bandhi	बंधी
krenge	क्रेंगे
ravish	रविश
nun	नून
ro	रो
gunehgar	गुनेहगर
naampata	नाम्पता
silent	साइलेंट
mode	मोड़
dadri	दादरी
malda	मालदा
porniya	पोर्निया
karnatak	कर्नाटक
punjab	पंजाब
suiciede	सुइसीड़े
rajput	राजपूत
tumlog	तुमलोग
paidaish	पीदीश
tumoog	तुमोग
nhi_kroge	न्ही_क्रोगे
ladkiyo	लड़कियो
ladkiyona	लड़कियोना
dalit	डालित
dekhti	देखती
roke	रोके
girane	गिरने
tabbah	तब्बाह
khelaf	खेलेफ
warzi	वर्ज़ी
aajj	आज्ज
pur	पूर
bachiyo	बचियो
keroge	केरोगे
hindustan	हिन्दुस्तान
durbhagya	दुर्भाग्य
dekhie-	देखिए-
najro	नजरो
gir	गिर
dilo	दिलों
krti	करती
akaon	अकाओं
phursat	फुर्सत
zimmedari	ज़िम्मेदारी
tehrana	तेहराना
ghatna	घटना
bijli	बिजली
paani	पानी
hak	हक
behtar	बेहतर
dikhaya	दिखाया
shasankaal	शासनकाल
capital	कैपिटल
sheila	शीला
naak	नाक
lanchhan	लांछन
brutal	ब्रुतल
prakash	प्रकाश
dalenge	डालेंगे
mahamahim	महमहिम
abhi_haal	अभी_हाल
parso	परसो
h_krni	ह_क्रनी
hu_dil	हू_दिल
jase	जसे
chola	चोला
odhkar_faltubazi_krre	ओढ़कर_फलतुबाज़ी_क्र्रे
ho_na	हो_ना
pane	पने
k_lie	क_लिए
sankhya	संख्या
badhi	बढ़ी
surakasha	सुरक्श
intejaam	इंतेजाम
insaaniyat	इंसानियत
sharmsaar	शर्मसार
rai	राय
asa	आसा
bengaldesh	बंगाल्देश
yogi	योगी
seekho	सीखो
faisley	फ़ैसले
manhoos	मनहूस
hudda	हुद्दा
hatao	हटाओ
namleva	नमलेवा
jitaya	जिताया
parwah	परवाह
panipat	पानीपत
faridbad	फरिद्बड़
mutabik	मुताबिक
america	अमेरिका
azma	आजमा
chukay	चुकाय
rapes	रेपस
karnatka	करनाटका
lug	लुग
padosi	पड़ोसी
dikhaie	दिखाईए
bhediye	भेड़िये
pade	पड़े
daalo	डालो
saalo	सालों
vase	वस
zarurat	ज़रूरत
mutilated	मुटिलेटेड
bhi_to	भी_तो
rani_padmini	रानी_पद्मिनी
k_upar	क_ऊपर
bni	बनी
vivad	विवाद
ldki	ल्डकी
speech	स्पीच
dedi	देदी
kamine	कामिन
aadami	आदमी
sudharenge	सुधरेंगे
gali	गली
gunda	गुंडा
muh	मुह
hmari	हमारी
samje	समझे
gadaaro	गदारो
zehar	ज़हर
murdabad	मुरादाबाद
kolkata	कोलकाता
dosh	दोष
nhi_karpari	न्ही_करपारी
waade	वादे
citizens	सिटीजन्स
hathiyaar	हथियार
vaishnodevi	वैष्णोदेवी
fauji	फ़ौजी
mulakat	मुलाकात
kahane	कहने
sunai	सुनाई
dardniya	दरदनिया
gharon	घरों
ghuskar	घुसकर
sharmnaak	शर्मनाक
bachao	बचाओ
rahengi	रहेंगी
niklegi	निकलेगी
padhne	पढ़ने
khauf	खूफ
punish	पुनीश
bajti	बजती
baj	बाज
skti	स्कती
asaram	आसरम
bapu	बापू
1bhi	1भी
saabit	साबित
ashram	आश्रम
charity	चरिटी
vedio	वेदियो
dekhne	देखने
anuj	अनुज
loya	लोया
besharam	बेशरम
tujhe	तुझे
adha	आधा
shohor	शोहोर
aksar	अक्सर
bachcho	बच्चो
salo	सैलो
procedure	प्रोसेडरे
guruji	गुरूजी
khas	खास
joki	जोकी
bangladesh	बांग्लादेश
bachoo	बचू
sikhana	सिखाना
seekhana	सीखना
baiti	बैठी
teereka	तेरेका
doodhna	दूधना
tarf	तर्फ
upakar	उपकर
ankho	आँखों
mukarne	मुकरने
gujaish	गुजऐश
kasab	कसब
sunane	सुनने
thappadd	ठप्पद
yakub	याकुब
menon	मेनन
moron	मोरों
zainab	ज़ैनाब
manane	मनने
khusi	खुसी
matam	मातम
esha	ईशा
honna	होना
jharkhand	झारखंड
asram	आसराम
pundit	पंडित
keya	केया
sadhu	साधू
kerti	करती
tension	टेंशन
gurgaon	गुड़गांव
safdar	सफ़्दर
tumari	तुमारी
baz	बाज
pooray	पूरे
pornography	पोर्नोग्राफी
qasoor	कसूर
padmaavti	पद्मावती
rahti	रहती
naari	नारी
swabhiman	स्वभिमान
kahun	कहूँ
tagg	टैग
jeene	जीने
divide	दीविड
mahabharat	महाभारत
kardiye	कर्दिये
koraput	कोरापुत
karliya	कार्लिया
johar	जौहर
hotay	होत्य
taluq	तालुक
liberalism	लिबेरलिम
kiyon	कियों
saktay	सक्तय
image	इमेज
pandit	पंडित
film	फिल्म
kisine	किसीने
banayega	बनायेगा
chomu	चोमू
tareef	तरीफ
kaanoon	कानून
apne-aap	अपने-आप
jaayenge	जायेंगे
humey	हमें
para	परा
lehaz	लहज
karay	करे
baitha	बैठा
mara	मारा
guzrti	गुज़रती
aurato	औरतो
bramhin	ब्रम्हीं
kamane	कमने
chad	चड
bordar	बॉरडर
qasur	क़सूर
samnay	सामने
maara	मारा
paralyze	परल्यए
pairo	पैरों
mehndi	मेहंदी
hatho	हाथो
kangan	कंगन
aajate	आजते
neta-	नेता-
apradh	अप्रढ़
barawa	बरवा
uthani	उतानी
bnanya	बनन्य
lnsan	लनसन
soche	सोचें
uthao	उठाओ
poochna	पूछ्ना
aapse	आपसे
ku	कु
mehnat	मेहनत
bich	बीच
laye	लाये
brahma	ब्रह्मा
lagaane	लगाने
sanskaar	संस्कार
rich	रीछ
fasakar	फ़साकर
unse	उनसे
ladka	लड़का
dharne	धरने
padmavat	पद्मावत
gia	गिया
cheezo	चीजो
ikathe	इकाठे
bewaqoofo	बेवक़ूफ़ो
bante	बंटे
filmo	फ़िल्मो
behas	बेहस
kiran	किरण
kher	खेर
raksha	रक्षा
gadhe	गधे
producer	प्रोडसर
chali	चली
khake	खाके
isike	इसीके
khikaf	खिकफ
aayege	आएँगे
valentine	वैलेंटाइन
shaan	शान
padmavati	पद्मावती
virudh	विरुद्ध
pak	पाक
chejo	चेजो
nirali	निराली
korodia	कोरोडिया
sambhalegi	सम्भालेगी
kaar	कार
baacho	बाचो
kark	कर्क
asi	असी
harqate	हरक़ते
isnhan	इसहान
kaap	काप
tujh	तुझ
gawaron	गवरों
pratidin	प्रतिदिन
violence	विऑलेंस
durdasha	दुर्दशा
deshbhakti	देशभक्ति
tekhedar	टेखेदर
padmaavat	पद्मावत
suwar	सुवार
mang	माँग
deshbhaft	देशभाफ्त
bano	बनो
aayngi	आऊँगी
nuksaan	नुकसान
hein	हें
sharab	शरब
prachlan	प्रचलन
hei	ही
payengi	पायेंगी
ghat	घाट
sanskar	संस्कार
jisne	जिसने
janma	जन्म
sukanya	सुकन्या
intna	इंटना
hungama	हंगमा
hogy	हॉग्य
aawaj	आवाज
dikhate	दिखाते
ldkiya	ल्डकिया
khti	खती
rhne	र्ने
marte	मरते
jimmedari	जिम्मेदारी
bhagna	भागना
kaya	काया
ghuinyan	घुइंयन
chhilne	छिलने
sram	श्रम
aani	आनी
netau	नेताउ
private	प्रीवाते
patti	पत्ति
inlogo	इनलोगों
nalayak	नालायक
admi	आदमी
ashwini	अश्विनी
chaudhary	चौधरी
puchana	पूछाना
jalaya	जलाया
dalito	डालिटो
dein	देन
nikalna	निकलना
bigadne	बिगड़ने
humlog	हमलोग
ladh	लाध
paaye	पाये
female	फेमले
rokte	रोकते
gaaye	गाये
kraane	क्राने
jaada	जाड़ा
voh	वोह
baajirao	बाजीराव
mastani	मस्तानी
karam	करम
morcha	मोरचा
karwana	करवाना
inspiration	इंस्पीरैशन
tune	तुने
marwa	मारवा
bawal	बवाल
rajasthan	राजस्थान
ischa	इस्च्छा
nirbhya	निर्भय
castinism	कस्टिनिस्म
khaa	खा
yarr	यार
itihas	इतिहास
bate	बातें
sense	सेन्स
chaalu	चालू
banaata	बनाता
15saal	15साल
jungleraaj	जंगलराज
kayam	कयाम
maam	माम
kaand	कांड
saans	साँस
schoolgirl	स्कूलगर्ल
paralyzed	परलिज़ेड
hindus	हिंदू
kaunga	कौंगा
padmavathi	पद्मावती
slogens	स्लोगेन्स
hayen	हाएं
bhaad	भाड
nirbhayakand	निर्भयकंद
hogye	होग्ये
vahan	वहाँ
haqq	हक़्क
pseudo	सिउडो
lagav	लगाव
everybody	एवेरिबडी
aansu	आँसू
yeduurappa	येदूरप्पा
shah	शाह
mopalwar	मोपालवार
mehta	मेहता
naitikta	नैतिकता
horahe	होराहे
dedijiye	देदीजिये
bheno	भेनो
hogua	होगुआ
tamam	तमाम
bhadr	भद्र
bnaye	बनाये
kidhar	किधर
rather	राथर
kyouki	क्योंकी
sanskriti	संस्कृति
du	दू
khilji	खिलजी
bhrasht	भ्रष्ट
mansik	मानसिक
shareerik	शरीरिक
pahele	पहले
jakhmari	जख्मारी
bithaya	बिठाया
tumhari	तुम्हारी
salon	सैलून
badnam	बदनाम
sikandar	सिकंदर
sikhaya	सिखाया
chi	ची
ghoomar	घूमर
gane	गने
dhakkar	धक्कर
dikhana	दिखाना
kayi	काई
pehente	पहनती
dikhti	दिखती
padhkar	पढ़कर
farzi	फ़र्ज़ी
hadi	हदी
awara	आवारा
pokoda	पोकोडा
leval	लेवल
bharastachar	भरस्ताचार
dhayaan	ढ्यान
sakhat	सखत
karwai	करवाई
konsa	कोंसा
2saal	2साल
penis	पेनिस
hakk	हक
jauhar	जोहर
hamre	हमरी
punishment	पुनीशमेंट
medal	मेडल
jaakar	जाकर
jahaan	जहाँ
maane	माने
tayyari	तय्यारी
vapas	वापस
jaanch	जाँच
rapiest	रेपीस्ट
sidha	सीधा
phhasi	फ्हासी
chalata	चलता
tabkyun	तब्क्यों
karni_sena	करनी_सेना
shakti	शक्ति
nhi_aata	न्ही_आता
hazaro	हज़ारों
mahillae	महिलाए
harasment	हरसमेंट
sikhar	शिखर
hori_h	होरी_ह
dikhao_to	दिखाओ_तो
milegi	मिलेगी
nirnay	निर्नय
marz	मर्ज़
medicine	मेडिसिन
maamle	मामले
ganda	गंदा
janane	जनने
deshbhakt	देशभक्त
vichar	विचर
chapter	चाप्टर
idhar	इधर
hogya	होग्या
kamse	कमसे
maniye	मनिए
dhakne	धकने
izzat	इज्जत
khrb	खर्ब
payari	पायारी
chaku	चाकू
markar	मार्कर
karde	कर्दे
ahinsa	अहिंसा
mukhota	मुखोता
pahankar	पहंकार
samjao	समझाओ
bato	बातो
chalkar	छलकर
payar	पायर
samjaoge	समझाओगे
kisiko	किसीको
nakare	नकरे
assholes	आश्शोल्
nakli	नकली
banake	बनके
kom	कोम
katl	कत्ल
burqe	बुर्क़े
kaid	कैड
bakriyon	बक्रियों
chillane	चिल्लाने
jisko	जिसको
yezidi	येज़िदी
3saal	3साल
bacchiyo	बच्चियो
ranveer	रणवीर
singh	सिंह
bikni	बिकनी
uthata	उठता
maje	मजे
dekhte	देखते
padmavti	पद्मावती
phuchne	फूचने
khule	खुले
dhmki	ध्मकी
divar	दीवार
khadi	खड़ी
bachane	बचने
itihaas	इतिहास
gayin	गयीं
survivor	सुर्वीवोर
abadi	अबाड़ी
badti	बढ़ती
apse	अप्से
sehmat	सहमत
bhavnaon	भावनाओं
awashyak	अवश्यक
chain	चैन
ghanton	घंटों
administration	आद्मिनिस्ट्रेशन
uthane	उठने
samaaj	समाज
disha	दिशा
molestor	मॉलेस्टर
chuni	चुनी
paath	पाथ
mante	मनते
prachar	प्राचर
karein	करें
bete	बेटे
harami	हरमी
voter	वोटर
puchkar	पूचकर
aadikaalon	आदिकालों
jansankhya	जनसंख्या
badhti	बढ़ती
ghatnayein	घटनायें
nikle	निकले
gorakpur	गोरकपुर
children	चिल्ड्रन
adityanath	आदित्यनाथ
zaraa	ज़रा
poochho	पूछो
gau	गौ
napunsak	नपुन्सक
narazgi	नरदगी
jaogey	जाओगे
kaahe	कआहे
balidan	बलिदान
aiyaary	ऐयार्य
bhagoda	भगोड़ा
akshay	अक्षय
bhagta	भगता
antaryami	अंतर्यमी
aatmhatya	आत्महत्या
hongi	होंगी
inquilaab	इंक्विलाब
jindabad	जिंदाबाद
likhegi	लिखेगी
vardate	वरद्ते
badhengi	बड़ेंगी
khayal	खायाल
kass	कास
rajyon	राज्यों
karwaa	करवा
sarhad	सरहद
marta	मार्ता
roko	रोको
netikta	नेतिकता
mangne	माँगने
musalmano	मुसलमानों
maharashter	महाराष्टर
natikta	न्तिकता
haan	हाँ
sandip	सांदीप
nihalchand	निहालचंद
barkarar	बरकरार
shri	श्री
krishna	कृष्ण
rangoli	रंगोली
nahate	नहते
chhup	छुप
rrahe	राहे
janab	जनाब
bachoun	बचूँ
karnay	करन्य
waalay	वालय
sahid	सहिद
horaha	होराहा
hogayi	होगायी
gaurav	गौरव
aaghat	आघाट
milna	मिलना
childrape	चिल्ड्रपे
chetna	चेतना
phansi	फाँसी
pariwaron	परिवारों
samajik	समझीक
bahiskar	बहिसकर
aparadhon	अपराधों
daat	दात
dikhata	दिखता
besharm	बेशर्म
poochta	पूछता
ladhkiyon	लाधकियों
khula	खुला
ghumta	घूमता
rakhti	रखती
lgati	लगती
waalon	वालों
machaya	मचाया
jitney	जितने
dande	डांडे
machado	मचाडो
aabhar	आभर
bachchi	बच्ची
dilli	दिल्ली
gunehgaar	गुनेहगार
data	डाटा
atyachaar	अत्याचार
abki	अबकी
dadaji	दादाजी
lavanya	लावण्य
dehradun	देहरादून
janti	जंती
gande	गंदे
ghraph	घ्रफ
vaalon	वालों
padni	पदनी
mari	मारी
bhavnaye	भावनाये
bachchiyon	बच्चियों
rajputon	राजपूतों
shanubhuti	शानुभूति
dauran	दौरान
hotta	होत्ता
60saal	60साल
barbaadi	बर्बादी
zimmevaar	ज़िम्मेवार
bakht	बख्त
sabkuch	सबकुछ
inn	इन
sbhi	स्भी
sikho	सीखो
kasmiri	कस्मीरी
apnahi	अपनही
refujee	रेफुजी
bankar	बांकर
rahna	रहना
rahne	रहने
bahno	बहनो
beshya	बेश्या
rohingaiko	रोहिंगाको
basane	बसने
rokenge	रोकेंगे
murkh	मूर्ख
aandh	आँध
nakaamyabi	नाकामयाबी
chupane	छुपने
hindumuslim	हिन्दुमुस्लिम
ghatak	घटक
hosla	होसला
bhad	भड़
behatreen	बेहत्रीन
badolat	बडोलत
parhao	परहाओ
parkaro	पर्करो
haatiya	हाथिया
imandaari	इमनदारी
pardarshi	परदर्शी
sabkl	सबक्ल
musalman	मुसलमान
itniiii	इतनी
c*yapa	च*यापा
jahaa	जहां
bawaal	बवाल
kalpanik	कल्पनिक
bhaduron	बहादुरों
bacchiyon	बच्चियों
berehmi	बेरहमी
udhar	उधर
dikhaao	दिखाओ
kataane	कटाने
roye	रोये
dakaiti	डकैती
hindutv	हिन्दुत्व
lekr	लेकर
mahaul	महौल
khrab	ख्रब
atankwadi	अटन्कवाड़ी
sanghatan	संघटन
milkr	मिल्कर
haa	हा
kh	ख
failne	फेलने
bhdotri	भ्डोत्री
dikhaenge	दिखाएंगे
khalega	खलेगा
khaulate	खऔलते
badhate	बढ़ते
bachate	बचते
gaaliya	गालिया
nikali	निकली
shaant	शांत
rehna	रहना
maa-behen	मां-बेहन
gaaliyan	गालियाँ
dhamkiya	धमकिया
virodhiyo	विरोधियो
vishesh	विशेष
parjati	पर्जती
khuleaam	खुलेआम
aor	एओर
hatyaye	हत्याए
dosiyon	दोसियों
pakdwao	पकडवाओ
dhang	ढंग
padmawat	पद्मावत
uda	उड़ा
udate	उड़ते
ankh	आँख
paon	पाँव
engrave	एन्ग्राव
bikaau	बिकाऊ
dikhayi	दिखाई
karaane	कराने
kharuch	खरूच
medical	मेडिकल
adhar	अधर
nayaymile	नयायमीली
hariom	हरिओम
uni	यूनी
bhagwaan	भगवान
zor	ज़ोर
badnaam	बदनाम
aabro	आबरो
kharida	खरीदा
samjhege	समझेगे
shambhulaal	शम्भुलाल
virat	विरत
sanathan	सनातन
dharma	धर्मा
bachche	बच्चे
bacchon	बच्चों
saram	सारम
aad	आद
karvana	करवाना
dogle	डॉगल
insaano	इंसानों
agla	अगला
swarajya	स्वराज्य
badte	बढ़ते
polititians	पॉलिटीटियन
kuttay	कुट्टे
karain	करैण
chalay	चलय
mazloom	मज़लूम
takleeef	टकलीफ़
kamaal	कमाल
jahn	जहन
finale	फाइनेले
hina	हिना
priyank	प्रियांक
pakad	पकड़
bathroom	बाथरूम
masturbate	मस्तुर्बते
shaayad	शायद
nyaay	न्याय
jaayein	जायें
asharam	अशरम
dallo	डैलो
khaali	खाली
munh	मुँह
phain	फैन
sachai	सच्चाई
sabhyata	सभ्यता
viksit	विक्सित
kamzor	कमजोर
darinda	दरिंदा
ladkiyan	लड़कियाँ
phadd	फद
zulm	ज़ुल्म
sunchega	सुंचेगा
puchta	पूछता
bacchi	बच्ची
qatar	कतार
kroorta	क्रूर्टा
harek	हरेक
bhoolo	भूलो
bachhion	बछियन
amaanwiya	अमांविया
kritya	कृत्य
bahir	बहिर
tumhary	तुम्हरी
bhookha	भूखा
parta	पार्ता
yaqeen	यक़ीन
baachi	बाची
masjidoo	मस्जिदू
todne	तोड़ने
burayi	बुराई
raheti	रहती
sariyat	सरियत
jaagi	जागी
maange	मांगें
tanqeed	तंकीद
jago	जगो
kumbhkarni	कुम्भकरनी
ameithi	अमीथी
karvai	करवाई
chahie	चाहिए
hin	हीन
jimmevar	जिम्मेवर
politicise	पॉलिटिसिज
rahene	रहने
masjido	मस्जिदो
giraya	गिराया
vaha	वाहा
yahudi	यहुदी
mehi	मेही
marvaya	मरवाया
chorra	छोरा
purani	पुरानी
balatkaar	बलतकार
dikhega	दिखेगा
bolugi	बोलुगी
jimewar	जिमेवाड़
bahane	बहने
huya	हुया
leti	लेती
andhi	आँधी
nashila	नशीला
ladko	लड़को
puch	पूछ
aabhiyan	आभियन
mishra	मिश्र
pande	पांडे
bhaiyo	भैयो
turant	तुरेंट
tarika	तारीका
hatse	हैटसे
huae	हुए
pahkna	पहकना
jal	जल
program	प्रोग्राम
harayana	हरायण
jhankiyo	झंकियो
prakar	प्रकर
jhakiya	झकिया
shameel	शमिल
sudharne	सुधारने
mamuli	मामूली
paesa	पऐसा
khaya	खाया
kensi	केन्सी
bnane	ब्नाने
todte	तोड़ते
baithega	बैठेगा
rkhte	र्खते
ketne	केटने
waek	वाएक
tyaar	त्यार
dhajjiya	धज्जिया
bhayion	भाइयन
publicity	पब्लिसिटी
mahakaal	महकाल
abuse	अबुस्
tek	टेक
chalga	चलगा
bachhi	बच्ची
atyachryon	अत्याच्र्योन
atankvad	अटन्कवाद
godess	गोडेस
purana	पुराना
faridabad	फरीदाबाद
kash	काश
paate	पाते
leker	लेकर
hangama	हंगामा
raani	रानी
jaaker	जाकर
bachhate	बछते
samjhte	समझते
raajput	राजपुत
nange	नंगे
sant	संत
batade	बतादे
jain	जैन
naampe	नाम्पे
tumare	तुमरे
diniya	दिनिया
jinendra	जिनेन्द्र
liy	लिय
bannaiy	बन्नाय
kariy	करिय
imandar	इमन्दर
ghumte	घूमते
raho	रहो
bchao	ब्चाओ
bhadao	भटाओ
andaza	अंडज़ा
haryanvi	हरियानवी
rangeen	रंगीन
mizaz	मिजाज़
karty	कार्ती
ghalat	घालत
karvati	कार्वती
majhab	मज़हब
chapne	चपने
patrkar	पत्रकर
uthai	उठाई
giro	गिरो
shoot	शूट
babao	बाबाओ
madarse	मदर्स
aashram	आश्रम
rozgar	रोज़गर
haqiat	हक़ीत
door	दूर
bhagti	भागती
panchkula	पंचकुला
jeend	जींद
inme	इनमें
ispe	इसपे
karwayega	करवाएगा
putle	पुतले
fookega	फूकेगा
sabut	सबुत
azaadi	आज़ादी
maza	मज़ा
saat	सात
batado	बतादो
dhuljaingay	धुलजैंगाय
chamche	चमचे
dedhdrohi	देद्द्रोही
dhoodh	धूद
pilaye	पिलाए
phan	फन
kuchlne	कुछलने
padege	पड़ेंगे
budhdhe	बूढ़्धे
propaganda	प्रोपेगंडा
bula	बुला
samjhaya	समझाया
sahela	सहला
rasheed	रशीद
antinational	एंटिनेशनल
inshaallah	इनशाल्लाह
lagayega	लगायेगा
laa	ला
kariyo	करियों
jaahil	जाहिल
mileyga	मिलेगा
sheela	शीला
enko	एंको
afzal	अफ़्ज़ल
batna	बटना
enka	एंका
gandu	गांदु
ganja	गंजा
phoonka	फूँका
akkal	अक्कल
ayegi	आयेगी
jakar	जाकर
kanaiya	कनैया
burhanwani	बूढ़्हनवानी
bithake	बिठाके
bhejdo	भेजड़ो
rkhne	राखने
rashtra	राष्ट्र
dhundh	धुंद
najeeb	नजीब
yanha	यान्हा
wanha	वान्हा
nare	नारे
barbadi	बरबदी
key	की
doosrey	दूसरे
lagey	लगे
thha	था
kehate	कहते
gharpe	घर्पे
tukre	तुकरे
tuo	तुओ
bantete	बंटेटे
mita	मिटा
shaatir	शातिर
veer	वीर
kanhaiya	कन्हैया
patak	पटक
doosari	दूसरी
aaka	आका
chhapa	छपा
haqeeqat	हक़ीक़त
jawanon	जवानों
sochi	सोची
samjhi	समझी
sajish	सजीश
aesa	ऐसा
pachde	पछड़े
upaj	उपज
generation	जनेरेशन
khilaya	खिलाया
pilaya	पिलाया
chanda	चंदा
communist	कम्युनिस्ट
ideology	इडेओलॉजी
institutions	इंस्टीट्यूशन
ganesh	गणेश
padho	पढ़ो
museum	म्युज़ियम
banega	बनेगा
jaroor	जरूर
bulwao	बुलवाओ
barsao	बरसाओ
nidhi	निधि
razdan	राजदान
deshdrohi	देशद्रोही
faasi	फासी
inh	इंह
debates	देबट्स
nikalte	निकलते
bhaukna	भौकना
gholo	घोलो
zeher	जहर
sikhate	सिखाते
veteran	वेतरन
aslo	अस्लो
bhajan	भजन
kirtan	कीर्तन
birodhi	बिरोधी
jaao	जाओ
wahaan	वहाँ
sabkuchch	सबकुच्छ
bikegaa	बिकेगा
gamcha	गमचा
angle	एंगल
tihadi	तिहादी
mazdoor	मजदूर
aazadi	आज़ादी
pagalkhane	पगलखने
kejari	केजारी
kaafee	काफी
samjhnekeliye	समझनेकेलिए
khaake	खाके
chutiyapa	चुटियापा
anti-indians	एंटी-इंडियंस
logonke	लोगोंके
usike	उसीके
abhivyakti	अभिव्यक्ति
uthya	उत्या
lagg	लग्ग
feke	फेके
jawano	जवानों
hafij	हफीज
burhan	बुरआन
ginti	गिनती
muft	मुफ्त
buddhe	बुद्धे
ghoday	घोड्य
karlete	कार्लेट
kispe	किसपे
sunaar	सुनार
lauhar	लौहर
jnu	ज्नू
dekhkar	देखकर
dekhke	देखए
rho	रो
kabhe	कभे
ginavaya	गिनवाया
institute	इंस्टीट्यूट
slogans	स्लोगांस
vande	वंदे
bandhe	बंधे
naarebaazi	नारेबाज़ी
pdaaai	पड़ाई
rajnneti	रजन्नेती
sinha	सिन्हा
taan	तान
mandali	मंडली
majaq	मजक
brigade	ब्रिगेड
bardast	बरदस्त
jaat	जात
aarakshan	आरक्षण
santi	शांती
pathological	पेथोलॉजिकल
pahuchate	पहुचते
mill	मिल
udhaari	उधारी
jignya	जिग्न्या
buzane	बुझने
tovnhi	टॉवन्ही
bistar	बिस्तर
apana	अपना
bewkoof	ब्यूकूफ
dramebaaz	ड्रामेबाज़
netagiri	नेतागीरी
pattharbaji	पत्थरबाजी
laat	लात
dirohio	दिरोहियो
toli	टोली
dikhegi	दिखेगी
chhodoge	छोड़ोगे
doodh	दूध
dhula	धुला
murga	मुर्गा
chalegi	चलेगी
divas	दिवास
phar	फर
laal	लाल
chadhdhi	चढ़्धी
gate	गेट
bujurg	बुज़ुर्ग
sochte	सोचते
kunki	कुँकी
lagani	लगनी
nehru	नेहरू
muzaira	मुज़ैरा
jawahar	जवाहर
lal	लाल
pahdne	पहने
chachiji	चाछजी
rahem	रहम
karoo	करूँ
lagni	लग्नी
nikale	निकले
nikalenge	निकलेंगे
desdroh	देसद्रोह
aaropiyo	आरोपियो
gurmeher	गुरमेहर
riya	रिया
gunj	गूंज
lafda	लफ़ड़ा
muje	मुझे
karayen	कराएँ
banke	बाँके
dikhavo	दिखावो
patriot	पत्रियट
sahara	सहरा
jabran	जेबरान
hoshiyari	होशियारी
jhadne	झड़ने
dubenge	डूबेंगे
aarhe	आरहे
charsi	चारसी
lagenge	लगेंगे
kesi	केसी
nikalta	निकलता
ru	रु
rotiyan	रोटियाँ
todega	तोड़ेगा
chargesheet	चार्जशीत
hairani	हैरानी
sahiba	साहिब
shehla	शहला
chanel	चनेल
pathar	पत्थर
kankar	कंकर
badah	बढ़ा
din-imaandaar	दिन-ईमानदार
chehro	चेहरों
goonj	गूँज
bandhu	बंधु
jamaat	जमात
pagalo	पागलों
bhoke	भोक
khichane	खिचने
chuppi	छुप्पी
mitega	मिटेगा
pollution	पोल्यूशन
fare	फ़रे
rat	रत
sar-kar	सर-कर
smabhal	स्मांभाल
humme	हममें
yatra	यात्रा
subh	शुभ
aarmbh	आरम्भ
chembar	चेम्बर
saantvana	सांत्वना
kejri	केजरी
sakey	सके
kadakey	कड़के
dhuaon'	धुआओं'
leejie	लीजिए
hashtag	हश्तग
ramleela	रामलीला
jashan	जशन
istemaal	इस्तेमाल
kejriwalji	केजरीवालजी
logic-	लॉजिक-
wajhe	वाझे
pehele	पहले
dramebaaji	ड्रामेबाजी
khelo	खेलो
bewakoof	बेवकूफ
zameen	ज़मीन
haqiqat	हक़ीक़त
samasya	समस्या
nidan	निदान
kujh	कुझ
rukh	रुख
khubsoorat	खूबसूरत
pariyavarn	परियावर्ण
kamo	कमो
jabardasti	जबरदस्ती
saanson	साँसों
zindegi	ज़िंदेगी
challan	छल्लन
baton	बातों
khaasi	खासी
nae	ने
kejrival	केजरिवल
sae	सए
bagwan	बागवान
authorities	औथोरिटीज
shaam	शाम
bann	बन
phode	फोड़े
presstitute	प्रेस्टिट्यूट
charhca	चार्हका
wahin	वहीं
kedarnath	केदारनाथ
manegi	मनेगी
jalenge	जलेंगे
patriotism	पत्रियोटिस्म
pant	पंत
aukat	औकत
mehsoos	महसूस
patake	पटक
kosna	कोसना
srilankan	श्रीलंकान
environment	एन्वायरोनमेंट
srilanka	श्रीलंका
lagye	लग्ये
hanumanji	हनुमानजी
lanka	लंका
lagayi	लगयी
boond	बूंद
aajtak	आजतक
pehn	पहन
bikegi	बिकेगी
kri	करी
delihi	डेलीही
kismat	किस्मत
footi	फुटी
ilaaj	इलाज
waalo	वालों
shandar	शानदार
paane	पाने
bechaare	बेचारे
jadu	जादू
dhup	धूप
dehli	दहली
doshi	दोषी
pahuchane	पहुचने
aalam	आलम
jahir	जहीर
rhte	र्ते
lgwa	लग्वा
bhasanbazi	भास्नबाज़ी
hookah	हुकह
atakk	अटक्क
pranaam	प्रणाम
kissa	किस्सा
kehti	कहती
badhaane	बढ़ाने
bahri	बहरी
dushmano	दुश्मनों
dikat	दिकट
padiye	पड़िये
businessman	बुसिनेस्मान
pite	पीते
jaayegi	जाएगी
chita	चिता
jalne	जलने
cha	चा
sambhog	संभोग
ramrahim	रामराहीम
chla	क्ला
kaslo	कस्लो
srilanakan	श्रीलनकन
pari	परी
pehene	पहने
dekhenge	देखेंगे
drohi	द्रोही
ghoshit	घोषित
hawa	हवा
lankan	लंकन
shaher	शहर
dhua	धुआ
pataakhe	पताखे
jeena	जीना
aayein	आयें
mirza	मिर्जा
ghalib	ग़ालिब
khayenge	खाएंगे
jhelna	झेलना
jaag	जाग
khilwaad	खिलवाड़
cabwala	केबवाला
rehti	रहती
dua	दुआ
baddua	बद्दुआ
meharbaani	मेहरबानी
milege	मिलेंगे
nashe	नाशे
kharch	खर्च
jio	जियो
becha	बेचा
bathe	बाते
mehengai	मेहंगाई
kidh	किध
sudhro	सुध्रो
behanchod	बहन्छोड
jhooti	झूठी
recharge	रेचार्ज
padte	पड़ते
meethi	मीठी
pakka	पक्का
tower	टॉवर
irada	इरादा
chahia	चाहिया
khudke	खुदके
jigar	जिगर
bakwaas	बकवास
sathiya	सथिया
jesse	जेससी
wasehi	वसही
fokat	फोकट
mahenat	महनत
sim	सिम
jite	जीते
jhate	झते
matke	मटके
kaye	काये
tarfse	तार्फ़्से
jabab	जबब
sochate	सोचते
leni	लेनी
bhaari	भारी
matra	मातृ
arvind	अरविंद
jitnr	जितन्र
sharmnak	शर्म्नक
neya	नेया
bebash	बेबश
taqatwar	ताकतवार
bekar	बेकर
nikammi	निकम्मी
mujh	मुझ
hajaro	हजरों
thi	थी
saaala	साला
khatwaria	खटवारिया
sarai	सराय
floor	फ्लोर
chadna	चडना
danya	दान्य
mukesh	मुकेश
chamber	चंबर
ilake	इलाके
taar	तार
gadhbad	गध्बाद
kadai	कड़ाई
shanti	शांति
layak	लायक
kripa	कृपा
hojaega	होजाएगा
maaja	माजा
uthaega	उठाएगा
waaoo	वाऊ
loogo	लूगो
baana	बाना
karaunga	कराऊंगा
yadi	यदि
fukhti	फुखती
chu	चू
vaada	वादा
kana	कना
koshih	कोशीह
langda	लंगड़ा
raam	राम
milae	मिलाए
jodi	जोड़ी
kodi	कोड़ी
shilpa	शिल्पा
april	अप्रैल
shona	शोना
jaanu	जानू
karwado	करवादो
waala	वाला
chutiyappa	चुटियाप्पा
hojayega	होजायेगा
khareed	खरीद
bhagvan	भगवान
tayyar	तय्यार
bhandara	भंडारा
ullu	उल्लू
page	पाग
dalali	दलाली
mitra	मित्र
nikkami	निक्कामी
chaloo	चलूँ
bhartiya	भारतीय
saharnpur	सहर्नपुर
sewaye	सेवाए
maharbani	महर्बनी
khela	खेला
chhapara	छपरा
gorakhpur	गोरखपुर
chodi	छोड़ी
jioabhi	जियोभी
bhaaii	भाई
chutiyappaa	चुटियप्पा
taake	ताके
duaao	दुआओ
chattisgarh	छत्तीसगढ़
sukma	सुक्मा
lagwa	लगवा
umpires	उम्पाइर्स
trai	ट्राई
jaiso	जैसो
jant	जंत
chuste	चुस्ते
akbar	अकबर
darbaar	दरबार
birbal	बीरबल
jhopda	झोपड़ा
maaka	माका
bhosda	भोसदा
pal	पल
intzaar	इंतज़ार
dhamaka	धमका
kaaram	कारम
namala	नमला
nalla	नल्ला
aakitaan	आख़ितान
ton	तों
lokki	लोक्की
dekhde	देखड़े
chlegi	च्लेगी
yehh	यह
vaah	वाह
mukeshbhai	मुकेशभाई
saall	साल
mujhse	मुझसे
roothkar	रूथकर
kauno	कौनो
firki	फिर्की
surprise	सुरप्राइज
smjha	स्म्झा
dekhni	देखनी
ehsaan	एहसान
mashup	मशूप
chhu	छू
bhosdiwalo	भोसदिवालों
phek	फेक
maarunga	मारूँगा
kaisi	कैसी
niyukti	नियुक्ति
kho	खो
bij	बीज
lu	लू
patanjali	पतांजलि
takkar	टक्कर
sandipsikdar	सांदीप्शिकदर
choker	छोकर
khelti	खेलती
vipaksh	विपक्ष
badminton	बैडमिंटन
jiyo	जियो
dharam	धरम
sikh	सिख
isai	ईसाई
aara	आरा
jaaniye	जानिए
sadhna	साधना
pavitra	पवित्र
sastra	शास्त्र
aadhar	आधार
baazigar	बाज़ीगर
jeeta	जीता
chauka	चौका
player	प्लेयर
bheje	भेजे
pathake	पाठके
phod	फोड़
zubaan	ज़ुबान
kesree	केस्री
aitbaar	ऐतबार
sehra	सेहरा
dariya	दरिया
okuhara	ओकुहारा
siddh	सिद्ध
bharatia	भारतइया
run	रून
manish	मनीष
pandey	पांडे
disease	डिसीज
kind	किंड
haro	हरो
haara	हारा
sindhu	सिंधु
chhori	छोरी
pakistanion	पाकिस्तान्न
kheli	खेली
utni	उतनी
paaya	पाया
jeetna	जीतना
janne	जान
karre	करे
dhara	धारा
bibaranee	बीबरनी
sanjaya	संजया
gold	गोल्ड
congratulations	कान्ग्रातुलशन्स
shabash	शबाश
adhaar	अधार
ashutosh	आशुतोष
bakchodi	बेकचोड़ी
hujuri	हुजूरी
pushton	पुष्टों
pahuchne	पहुचने
suda	सुडा
biwiya	बीविया
bataunga	बताऊँगा
tatte	तत्ते
khuja	खुजा
ladti	लड़ती
nakaam	नाकाम
pados	पड़ोस
auntiyon	ऑन्तियों
samajhta	समझता
viva	विवा
bachaayega	बचाएगा
azaad	आज़ाद
filhaal	फिल्हाल
susu	सुसू
haye	हाये
kahana	कहना
gana	गना
kisake	किसके
batana	बताना
midiya	मिड़िया
chij	चिज
tri	त्री
dilai	दिलाई
iradon	इरादों
suli	सुली
chadhaya	चढ़्या
abh	अभ
resignationprasad	रेसिग्नेशनप्रसाद
doglapan	डगलपन
jakaar	जकार
dalne	दलने
nana	नाना
nirahu	निराहु
ordinary	ऑर्डिनारी
niche	नीचे
jankaari	जानकारी
hmesha	हमेशा
dedo	देदो
baachoge	बाचोगे
sardana	सरदाना
irade	इरादे
utarta	उतारता
manaye	मनाये
begairat	बेगैरत
jumlebaj	जुमलेबाज
gajab	गजब
palti	पलती
maroge	मरोगे
khudko	खुदको
kitaab	किताब
shaksh	शक्ष
dikhaane	दिखाने
kunal	कुणाल
ladykiller	लडिकिलर
bayan	बयाँ
chara	चारा
nanga	नंगा
awasta	आवास्ता
phirse	फिरसे
chutyapa	छुट्यापा
isne	इसने
pakde	पकड़े
chhin	छीन
greebon	ग्रीबों
nagna	नागना
awastha	अवस्था
adhikar	अधिकार
shankar	शंकर
duhaai	दुहाई
padhe	पड़े
privatisation	प्रीवतीसशन
isteefa	इस्तीफा
doon	दूँ
damaad	दामाद
dhoond	ढूँद
methods	मेथेड्स
laakar	लाकर
hataa	हटा
jaydatar	जयदातर
bangkok	बंकॉक
nepali	नेपाली
gaand	गांड
choor	चूर
sarkaari	सरकारी
bajrang	बजरंग
dhandaa	धनडा
liyaa	लिया
puche	पूछे
gobar	गोबर
nahane	नाहने
mummy	मम्मी
krhe	क्रए
faayda	फायदा
pahuche	पहुचे
photo	फोटो
achhi	अच्छी
chaava	चावा
chaavi	चावी
bhang	भंग
guggiji	गुग्गिजी
khabardar	खबरदर
mangi	मांगी
padhna	पढना
usey	उसे
apney	अपने
dusare	दूसरे
digvijay	दिग्विजय
pan	पान
deewar	दीवार
dialog	डायलॉग
amitji	अमितजी
bungla	बंगला
shashiji	शशिजी
nijta	निजता
mohar	मोहर
lahadhi	लहधी
chupa	छुपा
saara	सारा
karaoge	कराओगे
bolonge	बोलोंगे
vyas	व्यास
photoshoot	फोटोशूट
tala	ताला
lagna	लगना
chiye	चिये
islifa	इसलीफा
palat	पलट
duga	दुगा
indians	इंडियंस
chalate	चलते
faisale	फ़ैसले
chutiye	चुटिये
dekhtha	देखता
keechtha	कीचता
darwaaja	दरवाजा
kula	कुला
nahaunga	नाहूँगा
aarmy	आर्मी
mainey	मैने
nijhta	निजता
taur	तौर
rashtrapati	राष्ट्रपति
bhavan	भवन
naamo	नामो
nishaan	निशान
mitt	मित्त
shosha	शोशा
visa	वीसा
millay	मिल्लय
gha	घा
gire	गिरे
kabtalak	कब्टलक
chorhte	चोड़ते
rahoge	रहोगे
sadme	सदमे
sarma	सरमा
atankwaadi	अटनकवादी
girega	गिरेगा
japanese	जापन
shar	शर
bede	बेड़े
kujam	कुजम
baloch	बालोच
tao	ताओ
herani	हीरानी
aaisey	आइसे
julteey	जुलतीय
jaisey	जैसे
jitwayaa	जितवया
aaney	आने
rehtha	रहता
shumali	शुमाली
bari	बारी
charh	चाढ़
fenk	फेंक
bigaad	बिगाड़
havan	हवन
dhamkion	धमकीन
kharja	खर्जा
badalnay	बदलनय
elaan	एलान
tabdilian	ताब्दिलियन
afghanistan	अफगानिस्तान
halak	हलक
parri	परी
phuppo	फुप्पो
larka	लार्का
mulaqat	मुलाकात
yad	याद
kharb	खर्ब
kuo	कुओं
dekta	देकता
padd	पद्दा
nazre	नज़रे
tikk	टिक्क
rahay	रहाय
bhaiyaa	भैया
bik	बिक
badho	बढ़ो
bakhi	बखी
najayez	न्जायेज
wajood	वजूद
uthe	उठे
nara	नारा
banaege	बनाईगे
dekhane	देखने
january	जान्वरी
kille	किले
virata	वीरता
puraskar	पुरस्कार
sanmanit	संमानित
khyal	ख्याल
waqi	वकी
nasal	नेसल
mazaa	मज़ा
afridi	अफरीदी
retirement	रेतिर्मेंट
bulao	बुलाओ
luta	लूटा
chahete	चहते
haad	हाड़
smjhao	स्मझाओ
zamana	ज़माना
guzar	गुज़र
barma	बर्मा
ilzam	इल्ज़म
sabot	सबॉट
martaba	मर्तबा
imran	इमरान
awam	आवाम
mahno	महनो
pechle	पेछले
saloon	सैलून
dehshatgari	दहशतगरी
lar	लर
qabaniyan	काबनियाँ
nakami	नाकमी
daagh	दाघ
lagana	लगना
bardasht	बर्दष्ट
qabil	क़ाबिल
pojte	पोजते
galiyan	गलियाँ
balke	बल्के
polices	पुलिसेस
amal	अमल
giya	गिया
gheera	घीरा
sahib	साहब
kasar	कसर
billion	बिलियन
dollars	डॉलर
jhaang	झाँग
dehshagardi	दहशागर्डी
jisase	जिससे
humhi	हमी
khunnas	खुन्नस
dabake	दबके
chehra	चेहरा
obama	ओबामा
taarif	तारीफ़
ghtya	घ्त्या
language	लैंग्वेज
khulasa	खुलसा
bigar	बिगर
kaan	कान
rakho	रखो
khair	खैर
khudara	खुदारा
apnay	अपन्य
sattu	सत्तु
pee	पी
yhan	य्हान
karode	करोड़े
anuyayeeyon	अनुययीयों
nyaya	न्याय
mujhay	मुझय
faad	फाड़
zukerburg	जुक्रबर्ग
kadak	कड़क
supari	सुपरी
kehekar	कहकर
bimari	बीमारी
waqae	वकाई
popularity	पॉपुलरिटी
teji	तेजी
chhut	छुट
yarana	यारना
nango	नांगो
islambd	इस्लाम्ब्द
bhookh	भूख
marega	मरेगा
aukad	औकड़
chhoda	छोड़ा
bhuchal	भूचल
mujhko	मुझको
pehchaan	पहचान
rampal	रामपाल
maharaj	महाराज
krwao	क्रवाओ
bikar	बीकार
challenge	छलेंगे
dhokla	धोक्ला
swaad	स्वाद
joosne	जूसने
sunata	सुनता
buddhiwapsi	बुद्धिवाप्सी
hawan	हवन
yagya	यज्ञ
krwa	क्रवा
qurbani	कुर्बानी
jaegi	जाएगी
garnu	गरनु
shayed	शायद
dhande	धंडे
baniye	बनिये
trumpbhai	ट्रम्प्भाई
daring	दरिंग
chhayi	छाई
fiqr	फ़िक़्र
pyaase	प्यासे
bhuke	भूके
duja	दूजा
badshah	बादशाह
dosra	दोसरा
zabardasti	ज़बरदस्ती
deshwaasiyon	देश्वासियों
bhuktenge	भूक्टेंगे
ivanka	इवानका
adharit	अधरित
sammelan	सम्मेलन
udghatan	उदघटन
cultural	कल्चरल
rkha	रखा
haramkhor	हरमखोर
poty	पोटी
kadu	कडू
naukri	नौकरी
haramkhori	हरमखोरी
dhulai	धुलाई
kumbkaran	कुंबकरण
bap	बाप
shakal	शकल
tharey	थारे
bhootnikay	भूतनीकाय
buzdil	बुज़दिल
khussraay	खुसराय
khusray	खुसरे
rahogee	रहोगी
hairaan	हैरान
itane	इतने
sharif	शरीफ
kie	किए
waqar	वकार
zaka	ज़ाका
galliyan	गैल्लियाँ
zyda	ज़ैदा
chunavi	चुनवी
wadde	वाद्ड
pore	पोरे
banaa	बना
loge	लोगे
bhejoge	भेजोगे
pajee	पाजी
apnae	अपने
kutta	कुत्ता
marge	मार्ज
war	वार
karge	कार्ज
bambari	बाम्बरी
jalan	जलन
aja	आजा
photu	फोटू
khichwate	खिचवते
ethasik	एथासिक
katora	कटोरा
million	मिलियन
jhatka	झत्का
milay	मिले
ziyada	ज़ियादा
terrorism	टेररिज़्म
shikast	शिकस्त
naacha	नाचा
naachay	नाचय
zaleel	ज़लील
jalte	जलते
shak	शक
nigah	निगाह
daikh	देख
jhoote	झूठे
choro	चोरो
usa	उस
samajhdar	समझदर
bewra	बेवरा
chodega	छोड़ेगा
chehry	चेहरी
farq	फ़र्क़
nyota	न्योता
saayad	सायद
barwadi	बरवाड़ी
isiliye	इसीलिए
sadar	सदर
sangeen	संगीन
elazamon	एलाज़मों
bochar	बोचर
krdi	क्र्डी
maaro	मारो
ghas	घास
ghuske	घुसके
nawaz	नवाज़
dety	देती
chatna	चटना
kabr	कब्र
latke	लटके
pacha	पछा
karle	कार्ले
auqat	औकत
bhot	भोट
aaayegi	आयेगी
giving	गिविंग
bali	बाली
khamoshi	खामोशी
hairat	हैरत
angeezi	अंगीज़ी
qarar	करार
awaam	आवाम
rozi	रोजी
sehet	सेहत
takkay	टक्काय
kra	क्र
bheek	भीक
mangnay	मंगनाय
ummah	उम्माह
ktrhy	क्त्राई
krskta	क्रस्कता
hoskta	होस्कता
bhol	भोल
kharay	खराय
purey	पूरे
banta	बंटा
amriki	अमृकी
saddar	सद्दार
samjhai	समझाई
dosti	दोस्ती
aqalmand	अक़लमंद
jii	जी
gi	गी
shaath	शात
balochistan	बालोचिस्तान
uthaiye	उठाइये
junggles	जंगल्स
smbhalti	सम्भलती
chalen	चलें
humary	हमेरी
iran	ईरान
bolay	बोलए
waqai	वकाई
ziada	ज़्यादा
bezti	बेज़्ती
hashar	हशर
khwaja	ख्वाजा
daro	डरो
hojaye	होजाये
begherat	बेगेरात
dobara	दोबारा
musharraf	मुशर्रफ
mily	मिली
krdo	क्र्डो
sheikh	शेख
mardun	मार्दून
mun	मुन
gata	घटा
kholta	खोलता
mangny	माँगनी
dien	देन
ghairat	ग़ैरात
khoof	खूफ
raseeden	रसीदें
rona	रोना
sharum	शरम
haya	हया
chootiyas	छुतीपस
shekal	शेकल
bandaro	बंदरों
khelaaf	खेलाफ
bhonko	भोंको
defense	डेफेंस
ministry	मिनिस्ट्री
kigye	किग्ये
jang	जंग
janen	जानें
hamen	हमें
jawaab	जवाब
udher	उदेर
bandobast	बंदोबस्त
rahy	रही
bachay	बचाय
saccha	सच्चा
kuta	कूट
peche	पीछे
chamcha	चमचा
loog	लोग
lambe	लम्बे
desho	देशो
chhipaye	छिपाये
nainsafi	नैंसाफी
dhobi	धोबी
deshwasiyon	देश्वासीयों
bolega	बोलेगा
dusra	दूसरा
sunega	सुनेगा
becharay	बेचराय
ghuss	घुस
salwaar	सल्वार
waliyon	वालियों
humarey	हमरे
mumalik	मुमलिक
dilon	दिलों
jito	जीतो
nikalega	निकलेगा
rajnigandha	रजनीगंधा
paki	पाकी
nasbandi	नस्बंदी
bashartey	बशरते
pae	पए
chut	चूट
khisak	खिसक
kehdiya	कहदिया
subha	सुभा
chalejata	चलेजता
neeche	नीचे
tag	तग
urdu	उर्दू
kroo	क्रू
larty	लार्टी
rahnaa	रहना
shiddat	शिद्दत
hathon	हाथों
ukhadna	उखड़ना
maksad	मकसड
milane	मिलाने
shriman	श्रीमान
piddu	पीड्डुं
chalai	चलाई
version	वर्सन
siri	सिरी
reh	रह
hamain	हमें
pol	पोल
kholte	खोलते
hamaray	हमरे
itnay	इतने
barey	बरे
loootairey	लूटैरे
choona	छूना
admire	एडमिरे
don	डॉन
aese	ऐसे
qayamat	क़यामत
taap	ताप
kohli	कोहली
aaplog	आप्लोग
kutto	कुत्तो
shadab	शादब
praise	प्राइज़
kartay	करत्य
parhti	पढ़ती
banay	बनाय
prabhuuuu	प्रभु
rota	रोता
ghaddar	गद्दार
watan	वतन
patwariyon	पटवरियों
bhagoori	भागूरी
tuj	तुज
chase	चेस
talwar	तलवार
dhar	धार
goliyon	गोलियों
bouchaar	बुचार
dartaa	डरता
viru	वीरु
chakko	चक्को
choukko	चौक्को
dusri	दूसरी
rahke	रहके
hamra	हमरा
raftar	रफ्तर
khelate	खेलते
college	कॉलेज
paka	पका
itra	इत्रा
raabta	राबता
paaji	पाजी
autographed	ऑटोग्राफड
khelta	खेलता
holi	होली
behtarin	बेहतरीन
margdarshak	मार्गदर्शक
hathi	हाथी
marathi	मराठी
shikhar	शिखर
asani	असनी
amrapali	आम्रपाली
sachin	सचिन
vayu	वायु
kanika	कनिका
kapoor	कपूर
champion	चैंपियन
vohi	वोही
imaandari	ईमानदारी
rose	रोज़
radhika	राधिका
jersey	जर्सी
akash	आकाश
dikhadeti	दिखदेती
pakdna	पकड़ना
namunkin	नामुनकिन
inns	इनस
achcha	अच्छा
jeetne	जीतने
anushka	अनुष्का
maazrat	माज़रत
haaregi	हारेगी
samjhoge	समझोगे
charan	चरण
arey	अरे
anhoni	अनहोनी
multan	मुल्तन
sultan	सुल्तान
paji	पाजी
hogaa	होगा
sehwag	सेहवाग
chorh	चोर
khadakpur	खड़कपूर
pareshaan	परेशान
bhenchod	भेंछोड
pakadte	पकड़ते
yar	यार
jadeja	जडेजा
rajpoot	राजपूत
bhejna	भेजना
thalaivar	तलैवर
daa	डा
tendulkar	तेंडुलकर
rajesh	राजेश
seshadri	सेशादरी
captain	कप्टन
kardiya	कर्दिया
dai	दाई
vaye	वाये
aakha	आखा
laaudai	लाउदई
kyarnu	क्यार्नु
chhaina	छैना
balla	बल्ला
pakadna	पकड़ना
seekha	सीखा
baahar	बाहर
chhedega	छेड़ेगा
mukaddama	मुकद्दमा
ranchi	रांची
fikar	फिकर
qwahish	क्वाहिश
aaur	आऊर
baadal	बादल
daar	दार
arjun	अर्जुन
swachh	स्वच्
australia	ऑस्ट्रेलिया
thikane	ठीकाने
rahane	रहने
karga	करगा
khilaye	खिलाये
ishq	इश्क़
maja	मज
padarshan	पदर्शन
hotahai	होटहाई
tykse	टिकसे
stagit	स्टेगीत
lagake	लगाके
fansi	फंसी
akhiri	आखिरी
khwaish	ख्वाइश
khiladiyan	खिलाड़ियाँ
bhoomi	भूमि
poojan	पूजन
haiii	ही
budhaw	बुधओ
khilaoge	खिलाओगे
rakhoge	रखोगे
bhumi	भूमि
marna	मरना
tripathi	त्रीपति
karvake	करवाके
khwahish	ख्वाहिश
paazi	पाज़ी
shastri	शास्त्री
sambhalna	संभलना
haare	हारे
umpire	उम्पीरे
ungli	उंगली
uthayenge	उठायेंगे
glti	ग्ल्टी
haari	हारी
apnaye	अपनाए
rupay	रुपय
litre	लीटर
dhone	धोने
dhoya	धोया
nahe	नहे
kum	कुम
abhishek	अभिषेक
satam	सतम
bhatt	भट्ट
aajka	आजका
jheethna	झीठना
jheethe	झीठे
rohitu	रोहितु
laet	लेट
jap	जप
hokr	होक्र
rohit	रोहित
daba	दबा
legaya	लीगया
mahi	माही
kisii	किसी
akila	अकीला
dananjaya	धनंजया
bhuvneshwar	भुवनेश्वर
mahendra	महेन्द्र
khu	खू
bhuvi	भुवि
eke	एके
keu	केव
ekta	एकता
golden	गोल्डन
dekhta	देखता
dekhoonga	देखूँगा
wapas	वापस
chhodne	छोड़ने
harenge	हरेंगे
swami	स्वामी
chodhni	छोफनी
padhi	पड़ी
maahiya	माहिया
khelega	खेलेगा
kaptaani	कपतानी
chhodi	छोड़ी
kalti	कलती
gile	गीले
shikwe	शिकवे
taara	तारा
chamakte	चमकते
dhuru	धुरू
taare	तारे
aasmaan	आसमान
star	स्टार
dharti	धरती
pepsi	पप्सी
daye	दाये
uttrakhand	उत्तराखंड
khelna	खेलना
bhula	भूला
kaash	काश
sunkar	सुनकर
gambhir	गंभीर
naukari	नौकरी
lagwaya	लग्वाया
khasa	खासा
tyag	त्याग
mulayam	मुलायम
tyaagne	त्यागने
rakhu	रखू
lagauga	लगौगा
nibhaya	निभया
spirit	स्पिरिट
jariye	जरिये
maahi	माही
retire	रेतिरे
ekdum	एकडम
raas	रास
unhoni	उन्होंनी
thukra	ठुकरा
raina	रेना
rakhana	रखना
kheliye	खेलिए
mukt	मुक्त
gyen	ग्येन
sachme	सचमे
rhaa	रहा
pyaar	प्यार
idol	इडोल
yuvraj	युवराज
srinivasan	श्रीनीवासन
meiyappan	मियाप्पन
bhii	भी
choodi	चोड़ी
netaji	नेताजी
sikhna	सिखना
ussa	उस्सा
sikhe	सीखे
dhoniya	ढ़ोनिया
pita	पीता
orchestra	ऑर्केस्ट्रा
rahta	रहता
tabe	ताबे
ulti	उल्टी
kholi	खोली
dilya	दिल्य
ajke	अज्के
sakshi	साक्षी
dhavan	धावन
khiladi	खिलाड़ी
sandooko	संदूको
khudi	खुदी
buland	बुलंद
pooche	पूछे
raza	रज़ा
rkhna	र्खना
smjdaar	सम्जदार
cheeteh	चीतेह
baaz	बाज़
sandeh	संदेह
maat	मात
odi	ओड़ी
marenge	मरेंगे
marwate	मारवाटे
itani	इतनी
zabardast	ज़बरदस्त
shuruaat	शुरुआत
aadat	आदत
vishwash	विश्वश
chhor	छोर
misbah	मिस्बह
saahab	साहब
sambhaavit	संभावित
leejiye	लीजिये
usulo	उसूलो
takrana	टकराना
jarruri	जार्रुरी
yade	यादे
bhuli	भूली
nnhi	न्ही
dilaya	दिलाया
parivartan	परिवर्तन
khitaab	खिताब
captainship	कप्तानशीप
shaddi	शाद्दी
lodha	लोधा
saaheb	साहेब
sambandh	संबन्ध
hatke	हटके
hameshaa	हमेशा
jhatke	झत्के
jadega	जड़ेगा
kumi	कुमी
rotlu	रोतलू
thakur	ठाकुर
pujara	पुजरा
tali	ताली
bajane	बजाने
lele	लेले
dilaa	दिला
gangaa	गंगा
dheeraj	धीरज
chaandi	चांदी
keemti	कीमती
paseena	पसीना
maahiyaa	माहिया
rula	रुला
nayee	नयी
liyee	लिये
kregee	क्रेगी
raaz	राज
paunga	पाऊँगा
aaram	आरम
paega	पाएगा
chodni	छोड़नी
paged	पाग
indias	इंडियास
sriniwasan	श्रीनिवासन
chela	चेला
gadho	गधो
girate	गिरते
advani	अद्वानी
bengal	बंगाल
gari	गरी
papuva	पापुवा
budhimani	बुद्धिमनी
madarchod	मदर्छोड़
khandan	खांडन
baitho	बैठो
angrezi	अंग्रेज़ी
bhadiya	भदिया
kamjoor	कमजूर
mose	मोसे
rahana	रहना
mahapanchayat	महापंचायत
madhya	मध्य
emaa	एमा
karva	करवा
badee	बड़ी
ummeden	उम्मीदेन
anda	अंडा
akho	आखो
dhul	धूल
dhadam	धदम
gaddha	गद्ध
khulte	खुलते
bhaisahab	भऐसाहब
relaunch	रेलॉन्च
hongae	होंगाए
tiya	तिया
bolti	बोलती
bhure	भूरे
mehaj	मेहज
rakhdi	रखड़ी
dhabli	ढाब्ली
bjate	ब्जाते
rath	रथ
samhal	संहल
mrityu	मृत्यु
kagaar	कगार
ummedwaar	उम्मीद्वार
rajeev	राजीव
gadha	गधा
bachcha	बच्चा
size	साइज
porkho	पोर्खो
zabab	ज़बब
kiziye	किज़िये
mangane	मांगने
paoge	पाओगे
bharti	भारती
ekattha	एकत्था
tareeke	तरीके
khojh	खोझ
soya	सोया
jagaya	जगाया
jagaa	जगा
nani	नानी
susuri	सुसूरी
rajnetik	रजनेतिक
remark	रेमार्क
daalte	डालते
rahulji	राहुलजी
challange	छलेंगे
rashtragan	राष्ट्रगन
sunne	सुनने
karbi	करबी
huen	हुएं
ei	ई
hatya	हत्या
mitaana	मिटाना
chaahta	चाहता
uga	उगा
detain	देतेन
patharbaz	पत्थरबाज़
kin	किन
raajpooton	राजपूतों
karara	करारा
bhiwandi	भीवंडी
malegaon	मलेगांव
batati	बताती
jaya	जया
jaana	जाना
rehkr	रहर
pidito	पिडीतो
mafi	माफ़ी
inse	इनसे
papua	पापुआ
khichwane	खिचवाने
puchega	पूछेगा
mitron	मित्रों
ganga	गंगा
kushinagar	कुशीनगर
kisaan	किसान
insecticide	इन्सेक्टीसाइड
jaaun	जाऊँ
atmahatya	आत्महत्या
karlun	कार्लून
ibobiji	इबोबिजी
naga	नागा
modji	मोजी
imphal	इम्फाल
karza	कर्ज़ा
kahiye	कहिये
chhorne	छोर्न
dhakka	धक्का
karela	करेला
dharasabhya	धरसभय
kari	करी
sakse	सकसे
viral	विराल
pariwaar	परिवार
sensibility	सेन्सिबिलिटी
sathiyane	सथीयाने
banaane	बनाने
chodke	छोड़के
gathbandan	गठबंधन
revival	रेविवल
hopayega	होपाएगा
dhoka	धोका
rahkar	रहकर
swaarth	स्वार्थ
vyakti	व्यक्ति
vul	वुल
sikhayegi	सिखाएगी
darne	डरने
jaururat	जॉरूरत
rab	रब
atke	अटके
nikalkar	निकलकर
luksan	लुकसन
database	डेटाबसे
lokpriya	लोकप्रिया
jnta	जंता
sunti	सुनती
damdaar	दमदार
varsho	वर्षो
patel	पटेल
shehela	शहएला
indirectly	इंडिरेकली
punch	पंच
karvayega	करवाएगा
drohiyo	द्रोहियो
banenge	बनेंगे
jaatiwachak	जातिवाचक
shabdh	शब्द
jativad	जातिवाद
rahihe	रहीहे
naii	नाई
omar	ओमर
ghandi	घंडी
apase	अपसे
etali	एताली
rekh	रेख
chhore	छोरे
iskeliye	इसकेलिए
while	वेळ
baarathi	बारती
bajayenge	बजाएंगे
baaja	बाजा
mitr	मित्र
legal	लीगल
kolek	कोलेक
withdrawal	विथ्द्रावाल
siddhart	सिद्धार्ट
jhuta	झुटा
thahraoge	ठहराओगे
majburi	मजबूरी
mahatma	महात्मा
majbuti	मजबूती
chukana	चुकाना
darna	डरना
bhencho	भेंचो
bharose	भरोसे
bagalme	बागल्मे
desi	देसी
tootenge	टूटेंगे
kaum	कौम
chini	चीनी
terah	तेरह
jaante	जानते
bikne	बिकने
chalao	चलाओ
jaldibaaji	जल्दीबाजी
manager	मैनेजर
hahhaa	हहआ
sanskari	संस्कारी
dauure	दूरे
samband	संबन्ध
purpose	पूर्पोस
satya	सत्य
humhare	हम्हारे
ladne	लड़ने
bewajh	बेवझ
dharmkithekedari	धर्मकिठेकेदारी
jha	झा
vyapam	व्यापाम
gawahon	गवाहों
kahne	कहने
baazi	बाज़ी
umeedo	उम्मीदों
raag	राग
chah	छह
karwlo	करव्लो
krtey	क्रते
kissano	किस्सानो
sahii	सही
benchooo	बेंचू
haatho	हाथो
sarey	सारे
rashtrwadi	राष्ट्रवाड़ी
joi	जोई
saalbemisal	साल्बेमिसाल
fauj	फ़ौज
sudhir	सुधीर
maharathi	महाराथी
unake	उनके
bhav	भाव
prarthana	प्रार्थना
aarah	आरह
rathor	राठौर
bhee	भी
ekbar	एकबार
sunle	सुनली
ajtak	अजतक
doctor	डॉक्टर्
vyavasay	व्यवसाय
tahit	ताहित
subecha	सुबेचा
rakshak	रक्षक
lubhawan	लुभावन
badhawan	बढ़ावन
khatare	खतरे
ganti	गंती
bajawan	बजवान
tal	तल
nibhawan	निभावन
badd	बद
babbarsher	बब्बर्शेर
udaate	उड़ाते
jaunpur	जॉनपुर
gudgaon	गुडगाँव
timbuktu	टिंबुक्तू
bhaisaab	भऐसाब
khreedo	ख़रीदों
bhagte	भगते
smbhaal	सम्भाल
rae	रे
chize	चिज़
utpat	उत्पत
bharth	भर्थ
chahiy	चाहिय
global	ग्लोबल
tantra	तंत्र
vyarth	व्यर्थ
kiosk	कियोस्क
lagaygi	लगेगी
kendra	केन्द्र
nacho	नाचो
jihad	जिहाद
kabja	कब्जा
larai	लराय
sarkat	सरकात
khudka	खुदका
pehna	पहना
chlta	छ्ल्टा
charging	चार्जिंग
gaadi	गाड़ी
programme	प्रोग्राम
programm	प्रोग्राम
upbhog	उपभोग
chaska	चस्का
gaumutra	गौमूत्र
chodne	छोड़ने
jrurat	जरूरत
rhegi	रेगी
prathnidhi	प्रथनीधि
chhatraneta	छतरेनेटा
utne	उठने
gundo	गुंडो
udaiye	उदाइये
sawarne	सवार्न
pakudee	पाकुड़ी
prashikchand	प्रशिकचंद
aguaee	अगुआई
phale	फाले
samashya	समश्य
sudharo	सुधारो
pkode	प्कोड़े
karwae	करवाए
nayak	नायक
bideshi	बिदेशी
bail	बेल
industries	इंडस्ट्रीज
utpad	उत्पद
sanrakshan	संरक्षण
hamesa	हमेंसा
puchata	पूछाता
tuze	तुझे
samajhadaar	समझदार
hogai	होगाई
ghabrahat	घबराहत
samvidhaan	संविधान
oopar	ऊपर
ungaliyone	उंगलियोने
aapake	आपके
rita	रीता
talent	टैलेंट
bajaya	बजाया
netayon	नेतायों
dholak	ढोलक
divyango	दीव्यंगो
samajta	समजता
bolunga	बोलूँगा
padoge	पड़ोगे
modigg	मोडिग
soja	सोजा
sunna	सुनना
manlo	मनलो
khilao	खिलाओ
citizen	सिटीजन
ashleel	अश्लील
foto	फ़ोतो
kehlata	कहलाता
dadi	दादी
swarna	स्वर्ण
kartik	कार्तिक
zaroori	ज़रूरी
machaa	मचा
zaara	ज़ारा
karm	कर्म
karei	करी
faal	फ़ाल
ichaa	ईछा
hmne	हमने
kdar	कदर
samndar	समन्दर
bha	भा
mje	मजे
ribon	रीबों
kaatne	काटने
mann	मान
karvata	कार्वता
sunaya	सुनाया
zid	ज़िद
khaana	खाना
laaya	लाया
paddi	पद्दी
azaan	अज़ाँ
mundwalenge	मुंडवालेंगे
hoge	होगे
devta	देवता
ravan	रवण
haina	हैना
chhoriye	छोरिये
pakistano	पाकिस्तानो
sunn	सुन
niral	निरल
mutna	मुटना
chunni	चुन्नी
radio	रेडियो
firr	फिर्र
dummy	डमी
tabiyat	तबीयत
ummid	उम्मीद
banayeg	बनायेग
ujjvla	उज्जवला
labh	लाभ
krhi	कृई
aai	आई
jayda	जयदा
middile	मिड्डील
pidda	पीड्डा
mahsus	महसूस
paet	पेट
tavi	तवी
koshis	कोशिस
kiraya	किराया
savi	सवी
pra	प्र
likhte	लिखते
likhwaate	लिखवाते
tutne	टूटने
futne	फटने
shardi	शार्दी
pheli	फेली
kissan	किस्सन
rajsthan	राजस्थान
bhastacharse	भस्ताचार्स
pidithu	पीड़ीतुं
shanta	शांता
pyarchand	प्यारचंद
mandot	मंडोत
chitamba	चितम्बा
bhilwada	भीलवाड़ा
viswaas	विस्वास
rahogey	रहोगे
mitorn	मिटर्न
sunoge	सुनोगे
pardesh	परदेश
updesh	उपदेश
najidik	नाजिदिक
banjara	बंजरा
savdhan	सव्धन
adhikaro	अधिकारो
bolege	बोलीज
khte	खते
pidi	पीड़ी
aae	आए
chupe	छुपे
saadh	साध
lijiya	लीजिया
gareb	गरेब
deka	देका
bhekh	भेख
puchny	पूछनी
bachchy	बच्च्य
mujhy	मुझय
unhy	उन्ही
jabarjasti	जबर्जस्ती
mangbai	मंगबई
bekh	बेख
mangty	मांगती
jikske	जिक्स्के
nayayparnali	नययपर्नाली
nayay	नयाय
shoshan	शोषण
chaai	छाई
zyyada	ज़्य्यादा
badne	बढ़ने
jayiyo	जइयो
saraswati	सरस्वती
kunj	कुंज
warse	वार्से
ahwazhai	अहव्झ्हाई
majbooti	मजबूती
majboot	मजबूत
thakat	ताकत
indiahai	इंडियाहाई
jaaega	जाएगा
jaaenge	जाएंगे
deep	दीप
shatru	शत्रु
bagawat	बगावट
shukriya	शुक्रिया
sunta	सुनता
chchakkr	च्चक्क्र
sochni	सोचनी
namo	नमो
karawal	करवल
nagar	नागर
deko	देखो
jaaney	जाने
nhai	न्हाई
bawaseer	बवसीर
jehad	जेहाद
taj	ताज
mahal	महल
sardi	सर्दी
bhet	भेट
jhar	झर
pochh	पोछ
bitane	बिताने
parvah	पर्वाह
bdbole	बदबोले
thikana	ठिकाना
kosko	कोस्को
agitation	अगिटेशन
rampalji	रांपलजी
shirecharno	शिरेचरणों
aasirvad	आसिरवाद
modiaaj	मोदीआज
horha	होरहा
juthe	झूठ
bapuji	बापूजी
modimonhai	मोदीमनहाई
kaane	काने
ruke	रुके
jawabdehi	जवाब्देही
jatiwad	जतिवाड
gatha	गठ
ksa	कसा
dabaya	दबया
sunlo	सुनलो
gaurakchak	गौरकचक
bakhto	बख्तो
jach	जाच
karaegi	कराएगी
riha	रिहा
chata	छाता
ayaga	अयागा
humko	हमको
parmarthi	परमार्थी
mahinonse	महीनोंसे
bagato	बगाटो
recording	रिकॉर्डिंग
karvaye	करवाए
insaaf	इंसाफ
smaaj	समाज
buraiyo	बुरैयो
daak	डाक
sisyo	सिस्यो
aapji	आप्जी
wajase	वाजसे
janch	जंच
karao	करो
takki	टक्की
aapane	आपने
manki	मनकी
karwayahe	करवयाहे
pap	पप
asugas	असुगस
vah	वह
dhikarenge	धिकरेंगे
santrampalji	संत्रंपलजी
sachcha	सच्चा
karnewale	करनेवाले
sata	सता
santji	संत्जी
dhikar	धिकार
janamte	जनमते
billi	बिल्ली
charon	चारों
shajish	शाजीश
apradhi	अपराधी
jasa	जसा
dosi	दोसी
garhwali	गढ़वाली
banai	बनाई
hani	हानी
kishan	किशन
dhappa	धप्पा
maiyya	मैया
chuda	छूड़ा
manga	मंगा
dikhaate	दिखाते
mardana	मर्दना
kamzori	कमजोरी
kahti	कहती
chora	छोरा
pi	पी
azeeb	अजीब
kathore	कठोर
darpok	डरपोक
dara	डरा
nidar	निडर
chhora	छोरा
daikha	देखा
lade	लड़े
peeth	पीठ
thapthapane	थपथपने
lagvao	लगवाओ
jumlo	जुम्लो
fekne	फेकने
bahrosa	बॉरोसा
karen	करें
deshdrohiyo	देशद्रोहियो
paridam	परिदम
pdi	पड़ी
indain	इंडैन
isay	इसाय
khehtay	खेहतए
dunya	दुनिया
chitrol	चित्रोल
kehtey	कहते
ghul	घुल
chatai	चटाई
motrma	मोत्र्मा
hindustaniyo	हिन्दुस्तानियो
mangoge	मँगोगे
pizza	पिज्जा
nipta	निप्टा
fujio	फुजियो
kashmiryo	कश्मीर्यो
haarte	हारते
gaa	गा
hatehali	हटेहाली
jinhine	जिन्हीने
baaji	बाजी
lagai	लगाई
badiya	बड़िया
yaken	यकें
aaba	आबा
pathi	पथी
sil	सिल
isis	इसीस
hamne	हमने
separatist	सेपरटीस्ट
yaah	याह
bhejkar	भेजकर
barha	बारहा
panga	पंगा
phorh	फोर
utube	उतुब
peetne	पीठने
moka	मोका
barastey	बरास्ते
garjtey	गर्जते
dikhaiye	दिखाइये
missile	मिसाइल
daage	दागे
agye	अज्ञे
gand	गंड
unhi	उन्ही
ghoomte	घूमते
badle	बदले
prasar	प्रसर
balaji	बालाजी
bharte	भरते
sambhalay	संभालय
chalaingay	चलैंगाय
bhaio	भाइयो
kaaledhan	कालेधन
chichha	चिच्छा
bigadey	बिगड़े
mitroon	मित्रुन
kabar	खबर
khodni	खोदनी
padegi	पड़ेगी
bharati	भारती
mabni	मब्नी
qisam	क़िसम
qamar	कमर
bajwa	बाजवा
tabaah	तबाह
karata	करता
mandovi	मंडोवी
karayega	कराएगा
rkhi	रखी
usee	उसे
kavivar	कविवर
beghairaton	बेगैरातों
bhonkty	भोंक्टी
rehty	रहती
gobhi	गोभी
karwayenge	करवाएंगे
saaar	सार
akhand	अखंड
pahli	पहली
bastiyon	बस्तियों
sawaal	सवाल
uthae	उठाए
pehen	पहन
alvida	अलविदा
dosto	दोस्तो
pataa	पता
zut	ज़ुट
gei	गेई
doglepan	डॉगलपन
hadh	हद
aayaa	आया
dekhen	देखें
bhoolen	बूलें
canada	कनाडा
dekhai	देखाई
padai	पड़ाई
likhai	लिखाई
zoro	ज़ोरो
sarfaraz	सरफराज़
sharmindagi	शर्मिंदगी
modiya	मोदिया
huyi	हुई
haarne	हारने
ghayal	घायल
sina	सीना
tokh	तोख
uthrahai	उतराहाई
harane	हरने
parega	परेगा
einase	एइनसे
durghatana	दुर्घटना
mmgchqoda	म्मचओडा
shurwat	शुरवत
dekhaye	देखाए
robot	रोबोट
aayu	आयु
sardar	सरदार
iccha	इच्छा
seema	सीमा
balidaan	बलिदान
jaiga	जऐगा
duniyan	दुनियाँ
loha	लोहा
gadaro	गडरों
deshdrohio	देशद्रोहियो
hahakar	हहकर
dusman	दुश्मन
dar	दर
saham	सहम
natak	नाटक
jhel	झेल
muqaabla	मुक़ाबला
parrikar	परीकार
digvijaya	दिग्विजया
saheed	सहीद
sikhane	सिखाने
appka	आपका
nirupam	निरुपम
bayaan	बयान
bahes	बहस
atankistan	अटन्किस्तान
issey	इस्से
bika	बीका
tumhi	तुम्ही
gunssa	गुनसा
aasman	आसमान
aakroshit	आक्रोषित
pkda	पकड़ा
sahaj	सहज
revenge	रेवेंगे
girebaan	गिरेबान
dhamaal	धामाल
dare	डरे
lncinema	लन्सिनेमा
dayamehar	दयाम्हर
latkhor	लटखोर
hau	हौ
damdar	दमदर
mallikarjun	मल्लिकार्जुन
kharge	खार्ज
popular	पॉपुलर
ruko	रुको
mangta	मंगता
rahahain	रहहीं
laato	लातों
bhoot	भूत
baato	बातों
maante	मानते
aapiyon	आपियों
upa	उपा
aapiya	आपिया
keval	केवल
afwah	अफ्वाह
pahunch	पहुँच
jaison	जैसों
varosa	वरोसा
pahna	पहना
khisiyani	खिसियानी
khambha	खंभा
noche	नोचे
parts	पार्ट्स
taiyari	तैयारी
sima	सीमा
aatanki	आतंकी
nrajxy	न्राजई
pakisthan	पाकिस्थान
bahari	बाहारी
gadaar	गदार
khasi	खासी
banayi	बनायी
etni	एतनी
mitne	मिटने
badlav	बदलव
irado	इरादो
laadle	लाडले
bajaate	बजाते
dek	देक
kaheen	कहीं
muhtod	मुहतोद
aapiye	आपिये
sukud	सुकूड
bakhts	बख्त्स
puray	पुराय
rotiya	रोतिया
sekni	सेकनी
jeep	जीप
kud	कूद
manata	मानता
principal	प्रिंसिपल
jakhm	जख्म
khak	ख़ाक
abhisav	अभीसव
bhule	भूले
unhen	उन्हें
dalal	दलाल
chay	चाय
pradhanmantri	प्रधानमंत्री
bologe	बोलोगे
kehnewale	कहनेवाले
juti	जुती
aapna	अपना
bej	बेज
suhagraat	सुहाग्राट
karuga	करुगा
sochege	सोचेंगे
jaali	जाली
jiye	जिये
bhejhta	भेझता
chhodna	छोड़ना
ishwar	ईश्वर
suni	सुनी
aram	आरम
isee	इसी
atangwad	अतंगवाड
garibi	गरीबी
ahsaas	एहसास
badam	बदम
kesar	केसर
sang	संग
usnke	उसनके
panding	पंडिंग
dikhte	दिखते
pasuo	पसुओं
savidhan	सविधान
vahhh	वह
melord	मेलोर्ड
patang	पतंग
udane	उड़ने
puchhlu	पूछ्लू
bain	बैन
daalein	डालें
nigam	निगम
barre	बारे
pollute	पोलूटे
taiyaari	तैयारी
gehre	गहरे
jitega	जीतेगा
vhi	व्ही
dhumdham	धुमधाम
mnaya	म्नाया
bolane	बोलने
buddhijivi	बुद्ध्जीवी
mahajan	महाजन
fatwa	फतवा
manmana	मनमाना
plhe	प्ल्हे
jalaane	जलाने
bakre	बकरे
kaatenge	काटेंगे
anarsa	अनारसा
anokhi	अनोखी
mithaii	मिठाई
khelenge	खेलेंगे
patli	पतली
saani	सानी
todna	तोड़ना
bonus	बोनस
chhodke	छोड़के
khele	खेलें
balloon	बॉलूँ
khelne	खेलने
aatankwaadi	आतनकवादी
thwacha	थ्वाचा
kahelte	कहलते
beauty	ब्यूटी
baatna	बातना
bataa	बता
rishte	रिश्ते
shahenshah	शहंशाह
eye	इये
chashma	चश्मा
dikhna	दिखना
kaal	काल
aaraha	आरहा
karun	करूँ
chedhchaad	चेड़चाद
gulal	गुलाल
bhagwa	भगवा
akhilesh	अखिलेश
ramzaade	रमजादे
papu	पापू
batyega	बत्येगा
wli	व्ली
manai	मानाई
phone	फोन
dhanda	धंडा
jalao	जलाओ
kharaab	खराब
manayi	मनायी
badhaiyaan	बढ़ाइयाँ
khushiyan	खुशियाँ
samajdaaro	समजदारो
bigada	बिगड़ा
tyohar	त्योहार
pabandi	पाबंदी
kacheri	कचेरी
karani	करनी
padati	पड़ती
daag	दाग
environmentalist	एन्वायरोनमेंटलिस्ट
failta	फैल्टा
meva	मेवा
nuksan	नुकसान
bujargo	बुझार्गो
pakshio	पक्षियो
jeevan	जीवन
chidd	चिद्द
chauda	चौड़ा
phodenge	फोड़ेंगे
pluto	प्लुटो
aurangzeb	औरंगजेब
aulaadon	औलादों
asthma	अस्थमा
fekenge	फेकेंगे
madarchood	मदारोंऊड
betichood	बेटिचूड
phatake	फाटके
meherbaani	मेहरबानी
adsense	एडसेंस
karn	कर्ण
bigaada	बिगाड़ा
karege	करेंगे
ura	उरा
gudgudi	गुद्गुदी
lgi	ल्गी
bhaging	भगिंग
kamaye	कमाए
waley	वाले
guzarish	गुज़ारिश
paypal	पायपाल
lagayen	लगाएं
priya	प्रिया
virtual	वर्चुअल
khareedna	खरीदना
seekhlo	सीखलो
saturation	सैचुरेशन
hojao	होजाओ
dollar	डॉलर
trading	ट्रेडिंग
sikke	सिक्के
pheke	फेके
dalwane	दाल्वाने
bohat	बोहत
kutti	कुत्ती
leagal	लीगल
tender	टेंडर
amaanya	अमान्य
niklne	निकलने
pakdi	पकड़ी
bubble	बबल
maana	माना
pockets	पॉकेट
pey	पे
gobor	गोबोर
marungi	मारूँगी
ghamand	घमंड
malai	मलाई
gumrah	गुमराह
software	सोफ्त्वरे
krwana	क्रवाना
dikhanay	दिखन्य
gaalian	गालियन
rola	रोला
khaki	खाकी
jaein	जाएं
qatal	काताल
shahadat	शहादत
arre	अरे
himayati	हिमायती
laalat	लालत
rishvat	रिश्वत
loogoun	लूगोन
chahiyea	चाहिईया
gayea	गइया
hahahahaahaha	हहाहहाहाहा
divyanka	दीव्यंका
promote	प्रोमोटे
btati	बटती
likne	लिकने
nirav	नीरव
maalik	मालिक
jogging	जॉगिंग
lagage	लगागे
jayen	जाएं
utarne	उतरने
bhaga	भग
trap	त्रप
istemal	इस्तेमाल
banker	बैंकेर
jaraha	जराहा
adikar	आदिकर
samjhta	समझता
average	एवेराज
karwani	करवानी
mahino	महीनों
pension	पेंशन
theka	ठेका
karodpati	करोड़पती
kaale	काले
kamayi	कमयी
ujaagar	उजागर
punje	पंजे
girne	गिरने
dege	देंगे
punja	पंजा
nikla	निकला
karmayogi	कर्मयोगी
bramhastra	ब्रम्हास्त्र
jhooth	झूठ
yojana	योजना
bhatkhane	भटखने
heera	हीरा
salamat	सलामत
baksha	बक्शा
sunaa	सुना
pen	पेन
bechtaa	बेचता
swaziland	स्वाजीलैंड
safaid	सफ़ीद
lejane	लेजने
khulaase	खुलासे
chidambaram	चिदम्बरम
paayenge	पायेंगे
bhagaao	भगाओ
bhagnewala	भग्नेवाला
chokidaar	चोख़ीदार
module	मॉड्यूल
bhrstachaar	भ्र्स्टाचार
khoj	खोज
rhta	र्ता
shohrabuddin	शोहराबुद्दीन
sherni	शेरनी
mamla	मामला
zone	ज़ोन
danga	दंगा
chupchap	चुपछप
diikhate	दीखते
janpath	जनपथ
kamm	कम्म
milakar	मिलाकर
mangeshkar	मंगेश्कार
sanam	सनम
usase	उससे
jisane	जिसने
insult	इन्सुल्ट
nishpaksh	निष्पक्ष
patrakarita	पत्रकरीता
khaunga	खाऊँगा
garmia	गर्मिया
their	थेईर
mirchi	मिर्ची
hukam	हूकाम
jukane	झुकाने
sarahti	सरहती
fenku	फेंकु
velocity	वेलोसिटी
padhaya	पढ़्या
rakta	रक्त
chaap	चाप
inaguration	इनगुरेशन
baru	बरू
baath	बात
kalank	कलंक
imandari	इमंदरी
laoge	लाओगे
bhaiyaji	भीयजी
remote	रिमोट
rahte	रहते
manmohanji	मनमोहनजी
gadar	गदर
prem	प्रेम
katha	कथा
aaaa	आ
apani	अपनी
bheze	भेझे
andhbhakt	अंध्भक्त
kae	काई
boltae	बोलताए
sidhu	सीधुं
baatlaata	बातलाता
darta	डरता
madat	मादत
ratna	रत्न
indira	इंदिरा
prize	प्राइज़
doobi	दूबी
purskar	पुर्सकर
jaake	जाके
puchenge	पूचेंगे
preparation	प्रेपरेशन
manmohn	मनमोहन
itana	इतना
hanji	हंजी
vyapan	व्यापान
padke	पड़के
bolraha	बोलराहा
goonga	गूँगा
manmohansingh	मनमोहनसिंह
manao	मनाओ
liyen	लिएँ
sirjee	सिर्जी
ghotale	घोटाले
sabra	सबरा
kije	कीजे
hamala	हमाला
retey	रीते
taaluck	तालुक
naha	नहा
bachne	बचने
pahne	पहने
ismein	इसमें
doobenge	डूबेंगे
ana	आना
kuchla	कुचला
ijjat	इज्जत
kregi	क्रेगी
bhaagne	भागने
saalfailsarkar	सालफेल्सरकार
ghotaale	घोटाले
neerav	नीरव
upadate	उपड़ते
sonu	सोनुं
snapchat	स्नाप्चत
mahesh	महेश
sareh	सारह
milkeh	मिल्कह
lootneh	लूटनेह
master	मास्टर
gujarati	गुजराती
industrialist	इंडस्ट्रीलिस्ट
niklwane	निकलवाने
khda	खड़ा
pdta	पता
btaya	बताया
dokhe	दोखे
idhr	इधर
udhr	उधर
aur	और
nawabi	नवाबी
biriyaani	बीड़ियानी
tanhai	तन्हाई
letay	लेत्य
anokha	अनोखा
taandav	तांडव
intehaan	इन्तेहान
ho	हो
ke	के
masti	मस्ती
gayazamaana	गयाजमाना
ya	या
vivah	विवाह
vidhi	विधि
mantra	मंत्र
bin	बिन
dolna	डोलना
vivaad	विवाद
ek	एक
ajnabi	अजनबी
sa	सा
ehsaas	एहसास
sataye	सताए
barkha	बरखा
pyasa	प्यासा
o	ओ
humnawa	हमनवा
fariyaad	फरियाद
hum	हम
daastaan	दास्तान
sunaayein	सुनायें
shukravaar	शुक्रवार
na	ना
kajre	कजरे
dhaar	धार
motiyon	मोतियों
kabool	कबूल
piroliye	पिरोलिए
fida	फिदा
dakhila	दखिला
nagma	नगमा
ant	अंत
me	मे
haaraye	हाराए
bekarar	बेकरार
harayi	हराई
motor	मोटर
ne	ने
gam	गम
sathi	साथी
jaadu	जादू
chupke	चुपके
jo	जो
ye	ये
tham	तम
shivratri	शिवरात्रि
varshik	वार्षिक
shulk	शुल्क
imaam	ईमाम
loon	लूँ
bijuriya	बिजुरिया
mahfil	महफ़िल
mae	मे
oonpe	ऊनपे
ankhiyo	अँखियों
se	से
behte	बहतें
neende	नींदे
neendo	नींदो
nasha	नशा
bahon	बाहों
darmiya	दरमिया
kumbh	कुंभ
mela	मेला
rochak	रोचक
tatya	तात्या
sajnaa	सजना
bekaraar	बेकरार
dardeintazaar	दर्देंतज़ार
sharmohaya	शर्मुहया
kali	कली
khwaabomein	ख्वाबोमें
bahekta	बहकता
mahekta	महकता
hasna	हासना
mauja	मौजा
hi	ही
banoge	बनोगे
vatan	वतन
kalke	काल्के
yakin	यकीन
boli	बोली
bawra	बावरा
toh	तोह
chand	चाँद
chak	चक
le	ले
de	दे
todenge	तोड़ेंगे
saamna	सामना
naina	नैना
bewafa	बेवफ़ा
hargiz	हरगिज़
the	थे
sanchar	संचर
aanewala	आनेवाला
bakhuda	बखुदा
chetavani	चेतावनी
churaayi	चुराई
zakhmi	ज़ख्मी
e	ए
giger	गिगर
woye	वोये
to	तो
aaja	आजा
nichode	निछोड़े
gudiya	गुड़िया
rani	रानी
lata	लता
lamhe	लम्हे
pichchar	पिच्चर
nirdeshak	निर्देशक
masala	मसाला
yaaro	यारों
aazmaale	आज़माले
ghadi	घड़ी
tujhko	तुझको
k	क
ab	अब
jau	जौ
haaye	हाये
ve	वे
daadeiya	दादेया
rabba	रब्बा
mitaane	मिटाने
lungi	लूँगी
umeed	उम्मीद
dhoop	धूप
milaata	मिलाता
chingaari	चिंगारी
bhadake	भड़के
sawan	सावन
use	उसे
bujhaye	बुझाये
sako	सको
tan	तन
man	मन
jagran	जागरण
samachaar	समाचार
pahachane	पहचने
piya	पिया
haathon	हाथों
chalein	चलें
teetar	तीतर
do	दो
tikhi	तीखी
aankhein	आँखें
zahar	ज़हर
jaam	जाम
hergiz	हरगीज़
thay	तय
wafa	वफ़ा
sakay	सकाय
baake	बाके
chore	चोर
hone	होने
ate	आते
miloge	मिलोगे
dhoom	धूम
is	इस
wo	वो
tara	तारा
pam	पाम
aji	अजी
aise	ऐसे
geet	गीत
kasmein	कसमें
raahi	राही
jeeya	जीया
shayar	शायर
shab	शब
ghazal	ग़ज़ल
shayari	शायरी
suhavane	सुहावने
churaya	चुराया
izhar	इज़हार
safar	सफर
chahaton	चाहतों
jaaneman	जानेमन
gulbadan	गुलबदन
maaniye	मानिए
sapno	सपनों
falak	फलक
sooraj	सूरज
maddham	मद्धम
sholay	शोले
basanti	बसंती
naach	नाच
galey	गले
haseen	हसीन
deewangi	दीवानगी
nakhre	नखरे
parathe	पराठे
yaaron	यारों
lagan	लगन
tumsa	तुमसा
pradushan	प्रदुशन
nichooade	निचूड़े
hatiyaar	हटियार
vishwavidyalaya	विविद्यालय
sagar	सागर
taraste	तरासते
ras	रस
peenekeliye	पीनेकेलिए
in	इन
ped	पेड़
shatak	शतक
rakt	रक्त
chap	छप
ilayichi	इलायिची
beeda	बीड़ा
intazaar	इंतज़ार
bahaar	बहार
oh	ओह
jaanam	जानम
sharaarat	शरारत
awaas	आवास
raahein	राहें
chalati	चलती
woh	वो
raah	राह
girta	गिरता
samhalta	सम्हलता
chalchitra	चलचित्र
dakait	डकैत
zindgi	ज़िंदगी
kosh	कोश
yaadein	यादें
takraati	टकराती
ayurveda	आयुर्वेद
piaar	पिआर
laree	लारी
choote	चूटे
rang	रंग
khaeriyat	खएरियत
bananewale	बननेवाले
samaayi	समायी
un	उन
fizao	फ़िज़ाओं
barso	बरसो
sikhne	सिखने
khoobsurat	खूबसूरत
preity	प्रेत्य
zinta	ज़िंता
gaal	गाल
garmi	गर्मी
khayaal	ख़याल
barson	बरसों
yaro	यारों
hawayein	हवाएं
gungunayein	गुनगुनायें
poochhe	पूछे
tumse	तुमसे
khidki	खिड़की
tukda	टुकड़ा
mastaane	मस्ताने
zindgee	ज़िंदगी
Khan	खान
janamdin	जनामदीन
sapnon	सपनों
aakraman	आक्रमण
morni	मोरनी
tin	तीन
taana	ताना
sanjh	सांझ
dulhan	दुल्हन
badan	बदन
churaye	चुराए
saaware	साँवरे
tore	तोर
jiya	जिया
milke	मिल्के
aisa	ऐसा
ladna	लड़ना
jhagadna	झगड़ना
beruki	बेरुकी
mohobbat	मोहब्बत
babuji	बाबूजी
chalna	चलना
chhukar	छुकर
ishara	इशारा
ashik	आशिक
divana	दीवाना
darpan	दर्पण
samaye	समाए
siva	शिवा
hun	हूँ
jaanaa	जाना
soorat	सूरत
dekhoon	देखूँ
masha	माशा
gul	गुल
khilaegi	खिलाएगी
chanchal	चंचल
nain	नैन
mahangi	महंगी
abhinetri	अभिनेत्री
lagay	लगाय
avtaar	अवतार
likhe	लिखे
tujhpe	तुझपे
kavita	कविता
armaan	अरमान
aansuon	आंसुओं
beh	बेह
laagi	लागी
jwala	ज्वाला
saiyyan	सैयाँ
tooney	तूने
daala	डाला
dhadkan	धड़कन
ahimsa	अहिंसा
dhal	ढाल
gupt	गुप्त
sabzi	सब्ज़ी
amma	अम्मा
rashtriya	राष्ट्रीय
grameen	ग्रामीन
ugle	उगल
heere	हीरे
moti	मोती
durghatna	दुर्घटना
dainik	दैनिक
naaraz	नाराज़
mausam	मौसम
yudh	युद्ध
jyotish	ज्योतिष
dagar	डगर
mitenge	मिटेंगे
mama	मामा
saas	सास
bat	बात
bigad	बिगड़
adaye	अदाए
mane	मने
nau	नौ
dhale	ढले
kirki	किर्की
tale	तले
siti	सिटी
nakhreywali	नखरेय्वाली
gum	घूम
hee	ही
mukhyamantri	मुख्यमंत्री
patni	पत्नी
lauta	लौटा
makaam	मकाम
pukar	पुकार
lo	लो
baaraatein	बारातें
doli	डोली
laana	लाना
aksa	अक्सा
beach	बीच
ghuma	घुमा
inteha	इन्तेहा
reet	रीत
nukkadvaale	नुक्कड़वाले
khudaya	खुदया
assam	असम
nritya	नृत्य
palkon	पलकों
saaye	साये
shiv	शिव
shankarkanta	शंकरकांता
aankh	आँख
kajal	काजल
phaela	फाएला
paththar	पत्थर
galiyon	गलियों
ma	मा
sharmili	शर्मिली
sajane	सजने
behakta	बहकता
mehakta	महकता
nachle	नाच
nanha	नान्हा
munna	मुन्ना
paryatan	पर्यतन
vibhag	विभाग
hu	हू
eid	इड
bhais	भईस
danda	डंडा
maraa	मरा
matbhed	मतभेद
aakarshan	आकर्षन
rahoon	रहूँ
nazro	नज़रों
bhavar	भावर
shabnami	शबनमी
bheegi	भीगी
chandni	चांदनी
husn	हुस्न
yoon	यूं
chandani	चंदनी
raavan	रावन
talaash	तलाश
gathayein	गथाएं
beliya	बेलिया
roshan	रोशन
khullam	खुल्लम
chumma	चुम्मा
musafir	मुसाफिर
katte	कत्ते
shikayat	शिकायत
daraar	डरार
from	फ्र्म
veerzara	वीरज़ारा
ustad	उस्ताद
shehnai	शेहनाई
aakash	आकाश
sun	सुन
kurta	कुर्ता
sarson	सरसों
da	डा
saag	साग
milkha	मिलखा
vishnu	विष्णु
avatar	अवतार
chalchitron	चलचित्रों
lutiya	लुटिया
fayade	फ़ेयदे
jag	जाग
chhatra	छतरा
avval	अवआल
dana	दाना
gulabi	गुलाबी
aankhen	आँखें
adalat	अदालत
krishi	कृषि
udyog	उद्योग
poocha	पूछा
mohabbat	मोहब्बत
khwaab	ख्वाब
sajaati	सजाती
munha	मुन्हा
sipahi	सिपाही
paero	पएरो
ghungroo	घुँघरू
juda	जुदा
tadap	तड़प
nikalti	निकलती
rama	रामा
maula	मौला
nagame	नगमे
lagda	लगदा
kalian	कालियन
samajhti	समझती
chhuppa	छुप्पा
chhuppi	छुप्पी
khelen	खेलें
awo	आओ
chhupakar	छुपकर
chaloon	चलून
beete	बीते
hue	हुए
lamhon	लम्हों
kasak	कसक
bindiya	बिंदिया
lagati	लगती
laut	लूट
chodo	छोड़ो
beet	बीत
yara	यार
inna	इन्ना
kehndi	कहंदी
munafa	मुनाफा
bhagwad	भगवाद
gita	गीता
kahani	कहानी
hotho	होठो
sama	समा
hanse	हँसे
khil	खिल
roopa	रूपा
jhilmil	झिलमिल
crorepati	करोरेपती
nag	नाग
sambhle	संभले
julffa	जुल्फा
ikraar	इकरार
palke	पलके
palko	पलको
begana	बेगाना
lina	लीना
chaand	चाँद
nagama	नगमा
qurbaan	कुर्बान
dhun	धुन
aanewaala	आनेवाला
basa	बसा
nigaah	निगाह
zindagaani	ज़िंदगानी
dohe	दोहे
hume	हमे
dole	डोले
dahade	दहदे
jagaye	जगाए
daka	डाका
dale	डाले
naal	नाल
sanu	सानु
aazma	आज़मा
luck	लक
chhaiya	छैया
mukabla	मुकाबला
khat	खत
ladkee	लड़की
touba	टूबा
chahat	चाहत
maqbara	मकबारा
paryatak	पर्यटक
churayenge	चुराएंगे
banayenge	बनायेंगे
waada	वादा
judaa	जुदा
puchha	पूछा
